SKSKODE	TEKST
B	Behandlings- og plejeklassifikation
BA	Nervesystemet
BAB	Anvendelse af perkutan adgang til nervesystemet
BABD	Kateteranvendelse ved regionalanæstesi
BABZ	Delprocedure med rel. til perkutan adgang til nervesyst.
BABZ0	Anlæggelse af kateter til regionalanæstesi
BABZ00	Anlæggelse af epiduralkateter
BABZ1	Fjernelse af kateter til regionalanæstesi
BABZ10	Fjernelse af epiduralkateter
BAF	Nervestimulation, blokade og smertebehandling
BAFA	Specielle indgreb i neurologiske funktioner
BAFA0	Behandling med nervestimulation
BAFA00	Stimulatio radicis spinalis nervi sacralis
BAFA4	Behandling med ganglieblokade
BAFA40	Behandling med blokade af ganglion stellatum
BAFA41	Behandling med blokade af ganglion coeliaca
BAFA5	Behandling med blokade af truncus sympaticus
BAFA50	Behandling med blokade af truncus sympaticus thoracalis
BAFA51	Behandling med blokade af truncus sympaticus lumbalis
BAFA6	Smertebehandling med blokade
BAFA7	Smertebehandling med infiltrationsanæstesi
BAFA8	Smertebehandling ikke klassificeret andetsteds
BAFA80	Smertebehandling med akupunktur
BAFA81	Smertebehandling med inhalationsanalgesi
BAFA82	Smertebehandling med fysioterapi
BAFA83	Smertebehandling med zoneterapi
BAFA84	Smertebehandling med kiropraktik
BAFA85	Smertebehandling med laser
BAFA86	Smertebehandling med biofeedback
BAFA87	Smertebehandling med sterilvandspapler
BAG	Strålebehandling med relation til nervesystemet
BAGA	Strålebehandling af nervesystemet
BAGA0	Strålebehandling af centralnervesystemet
BAGA5	Strålebehandling af det perifere nervesystem
BAH	Medikamentel behandling med relation til nervesystemet
BAHL	Cytostatisk behandling af nervesystemet
BAHY	Med. behandling med virkning på CNS ikke klass.andetsteds
BAHY0	Behandling med stærke analgeticum
BAHY1	Behandling med svage analgeticum
BAHY2	Behandling med migrænemiddel
BAHY3	Behandling med antiepilepticum
BAHY4	Behandling med antiparkinsonmiddel
BAK	Pædagogiske interventioner med relation til nervesystemet
BAKH	Vejledning i interferonbehandling
BAL	Soignering mm. med relation til nervesystemet
BALF	Soignering af perkutan adgang til nervesystemet
BALF0	Soignering af epiduralkateter
BAX	Andre interventioner med relation til nervesystemet
BAXY	Interventioner rel.til nervesystemet ikke klass.andetsteds
BB	Det endokrine system og metaboliske lidelser
BBG	Strålebehandling med relation til det endokrine system
BBGA	Ekstern strålebehandling af det endokrine system
BBGA0	Ekstern strålebehandling af hypofysen
BBGA1	Ekstern strålebehandling af skjoldbruskkirtlen
BBGA2	Ekstern strålebehandling af binyre
BBGJ	Intern strålebeh (radioaktiv isotop) af det endokrine system
BBGJ0	Intern strålebeh. (radioaktiv isotop) af skjoldbruskkirtlen
BBGJ1	Intern strålebehandling (radioaktiv isotop) af binyrer
BBH	Med.beh.med virkning på det endokr.system o.a.metab.lidelser
BBHA	Peroral diabetesbehandling
BBHA0	Behandling med peroralt antidiabetikum
BBHA00	Behandling med insulinstimulerende middel
BBHA01	Behandling med glucosehæmmende middel
BBHB	Antithyreoid behandling
BBHC	Behandling med midler mod adipositas
BBHF	Hormonbehandling
BBHF0	Insulinbehandling
BBHF00	Insulinbehandling, 1-2 gg. terapi
BBHF01	Insulinbehandling, basal og bolus
BBHF02	Insulinpumpebehandling
BBHF1	Behandling med thyreoideahormon
BBHF2	Behandling med hypofysehormon
BBHF3	Behandling med binyrebarkhormon
BBHF4	Behandling med biskjoldbruskkirtelhormon
BBHF9	Hormonbehandling ikke klassificeret andetsteds
BBHF90	Hormonsubstitutionsbehandling ikke klassificeret andetsteds
BBHG	Behandling med kønshormoner og gonadotrope hormoner
BBHG0	Behandling med kvindeligt kønshormon
BBHG1	Behandling med mandligt kønshormon
BBHG3	Behandling med gonadotropt hormon
BBHG30	Behandling med ovariestimulerende middel
BBHG31	Behandling med FSH og LH
BBHG32	Behandling med GNRH analog
BBHG33	Behandling med GNRH antagonist
BBHL	Cytostatisk behandling af det endokrine system
BBHL0	Cytostatisk behandling af endokrint organ
BBHL00	Cytostatisk behandling af pancreas
BBHL01	Cytostatisk behandling af skjoldbruskkirtel
BBHL02	Cytostatisk behandling af binyre
BBHY	Med.beh.med virk.på det endokr.system/metab.lidel.ikke klass
BBHY0	Med. beh. af metab. knoglesygdom ikke klass. andetsteds
BBK	Pædagog.intervent.med rel. til det endokr.system o.a. metab.
BBKA	Oplæring i blodsukkermåling
BBKB	Oplæring i injektion af insulin
BBX	Andre interventioner med relation til det endokrine system
BBXA	Procedure med rel.til det endokr.system ikke klass. andetste
BBXA0	Mekanisk stimulation af Glomus Caroticum
BC	Øje og øjenomgivelser
BCD	Øjenbehandling med hjælpemidler og proteser
BCDD	Synskorrektion
BCDD0	Synskorrigerende behandling
BCDD01	Behandling med briller
BCDD02	Behandling med kontaktlinser
BCDD03	Behandling med svagtsynsoptik
BCDD9	Optisk behandling ikke klassificeret andetsteds
BCDE	Behandling med øjenprotese
BCDZ	Delprocedure ved behandling med øjenproteser
BCDZ0	Måltagning til øjenprotese
BCDZ1	Tilpasning af øjenprotese
BCF	Behandling af funktionsfejl i relation til synet
BCFL	Skelebehandling
BCFL0	Ortoptisk behandling
BCG	Strålebehandling med relation til øje og øjenhule
BCGA	Strålebehandling af øjenhule
BCH	Medikamentel øjenbehandling
BCHL	Cytostatisk behandling af øjenhule
BCHS	Behandling med midler mod øjensygdom
BCHS0	Oftalmologisk lokalbehandling med antibiotika
BCHS00	Behandling af bakteriel infektion i øje
BCHS01	Behandling af virusinfektion i øje
BCHS1	Lokalbehandling af øjne med antiinflammatorisk middel
BCHS2	Behandling af øjne med antiallergisk middel
BCHS3	Medikamentel glaukombehandling
BCHS9	Medikamentel beh. af øjensygdom ikke klass. andetsteds
BCHY	Beh.med midler mod øjensygdom ikke klass. andetsteds
BCHY0	Oftalmologisk lokalbehandling med antibiotika
BCHY00	Lokalbehandling af bakteriel infektion i øje
BCHY01	Lokalbehandling af virusinfektion i øje
BCHY1	Lokalbehandling af øje med antiinflammatorisk middel
BCHY2	Lokalbehandling af øje med antiallergisk middel
BCHY3	Medikamentel glaukombehandling
BCK	Pædagogiske intervent. i forb.med beh. Af øjensygdom
BCKA	Instruktion i behandling med øjendråber
BCKA0	Instruktion i drypning af øje
BCKA00	Instruktion af patient i drypning af øje
BCKA01	Instruktion af pårørende i drypning af øje
BCL	Rensning og vask med relation til øje
BCLA	Øjenskylning
BCLB	Rensning af øjenprotese og kontaktlinser
BCLB0	Rensning af kontaktlinser
BCLB1	Rensning af øjenprotese
BCLF	Forbinding af øje
BCLF0	Pålægning af øjenforbinding
BCLF1	Fjernelse af øjenforbinding
BCX	Andre interventioner med relation til øje
BCXA	Kompenserende handling ved beh.med kontaktlinse,protese mm.
BCXA0	Kompenserende handling mhp. anvendelse af kontaktlinser
BCXA1	Kompenserende handling mhp. anvendelse af øjenprotese
BCXB	Drypning af øje
BCXY	Interv. m. relation til øjet og øjenomg. ikke klass. a.steds
BCXY0	Påsætning af øjenklap
BD	Øre, næse, hals og strube
BDD	Behandling med høreapparat
BDDA	Høreapparatbehandling
BDDA0	Behandling med kanalhøreapparat
BDDA1	Behandling med conchahøreapparat
BDDA2	Behandling med ørehænger
BDDA3	Behandling med lommehøreapparat
BDDB	Speciel høreapparatbehandling
BDDB0	Høreapparatbehandling, BC (bone conductor)
BDDB1	Høreapparatbehandling. cross (contra routing of signal)
BDDB2	Høreapparatbehandling, bicross (bilateral routing of signal)
BDDD	Teknisk service til høreapparatbruger
BDDD5	Fremstilling af øreprop
BDDD50	Fremstilling af ekstern øreprop
BDDD51	Fremstilling af intern øreprop
BDDD58	Aftryk til øreprop
BDDD6	Tilpasning af høreapparat
BDDD60	Justering af programmerbart høreapparat
BDDD61	Tilpasning af høreapparat i frit felt
BDDD8	Reparation af høreapparat og tilbehør
BDDD80	Reparation af høreapparat
BDDD81	Reparation af øreprop
BDDD82	Service i forbindelse med øreprop
BDG	Strålebeh m relation til det oto-rhino-laryngologiske område
BDGA	Oto-rhino-laryngologisk strålebehandling
BDGA0	Strålebehandling af næse
BDGA1	Strålebehandling af bihuler
BDGA2	Strålebehandling af larynx
BDGA3	Strålebehandling af øre
BDH	Medikamentel oto-rhino-laryngologisk behandling
BDHL	Cytostatisk oto-rhino-laryngologisk behandling
BDHY	Med.oto-rhino-laryngologisk beh. ikke klass. andetsteds
BDHY0	Behandling med rhinologikum
BDHY00	Behandling med slimhindeadstringerende middel (næse)
BDHY01	Lokalbehandling med glukocorticosteroid (næse)
BDHY1	Medikamentel behandling af lidelse i ydre øre
BDHY2	Medikamentel behandling af lidelse i mellemøre
BDHY20	Med.beh. af transportsyge og vestibulære symptomer
BDK	Pædagog.interv. med rel.til oto-rhino-laryngologisk beh.
BDKA	Instruktion af høreapparatbruger
BDKA0	Instruktion i anvendelse af kanalhøreapparat
BDKA1	Instruktion i anvendelse af conchahøreapparat
BDKA2	Instruktion i anvendelse af ørehænger
BDKA3	Instruktion i anvendelse af lommehøreapparat
BDKC	Vejledning vedr. behandling af allergisk rhinitis
BDKC0	Vejledn. vedr. forebyggende behandling af allergisk rhinitis
BDL	Skiftning, rensning og soignering mm. med relation til øret
BDLA	Skiftning med relation til otologisk behandling
BDLF	Rensning og soignering med relation til øret
BDLF0	Rensning af høreapparat
BDX	Andre interventioner med relation til øre, næse, hals og str
BDXA	Otologisk behandling ikke klassificeret andetsteds
BDXA0	Fjernelse af ørevoks
BDXA01	Instrumentel fjernelse af ørevoks
BDXA02	Fjernelse af ørevoks ved skylning
BDXA1	Oprensning af radikalkavitet
BDXA3	Sugebehandling a.m. Proetz
BDXH	Interventioner vedr.brug af høreapparat ikke klass.andetsted
BDXH0	Kompenserende handling ved anvendelse af høreapparat
BDXH00	Kompenserende handling ved anvendelse af kanalhøreapparat
BDXH01	Kompenserende handling ved anvendelse af conchahøreapparat
BDXH02	Kompenserende handling ved anvendelse af ørehænger
BDXH03	Kompenserende handling ved anvendelse af lommehøreapparat
BDXY	Oto-rhino-laryngologisk intervention ikke klass.andetsteds
BE	Mundhule og svælg
BEC	Tandbehandling med implantater
BECA	Behandling med tandimplantater
BECA0	Udskiftning af distance
BECA1	Behandling med krone på enkelttandsimplantat
BECA10	Behandling med krone på enkelttandsimplantat i overkæben
BECA11	Behandling med krone på enkelttandsimplantat i underkæben
BECA2	Behandling med bro på implantater i delvis betandet kæbe
BECA20	Behandling med bro på implantater i delvis betandet overkæbe
BECA21	Behandling med bro på implantater i delvis betandet underkæb
BECA3	Behandling med fuldbro på implantater
BECA30	Behandling med fuldbro på implantater i overkæbe
BECA31	Behandling med fuldbro på implantater i underkæbe
BECA4	Dækprotesebehandling på implantater
BECA40	Dækprotesebehandling på implantater i overkæbe
BECA41	Dækprotesebehandling på implantater i underkæbe
BECA7	Behandling med foreløbig krone, bro og protese på implantate
BECA8	Reparation af krone, bro og protese på implantater
BED	Protesebehandling ved tandlidelser
BEDA	Behandling med tandproteser
BEDA0	Behandling med tandproteser (helprotese)
BEDA00	Behandling med helprotese i overmund
BEDA01	Behandling med helprotese i undermund
BEDA1	Behandling med tandproteser (partiel)
BEDA10	Behandling med delprotese i overmund
BEDA11	Behandling med delprotese i undermund
BEDA4	Rebasering og duplikering  af tandprotese
BEDA8	Reparation af tandprotese
BEF	Mund-, svælg- og ansigtsstimulation
BEFA	Isstimulation
BEFB	Mimiske øvelser
BEFC	Fasciooral behandling
BEG	Strålebehandling med relation til kæber, mundhule og svælg
BEGA	Ekstern strålebehandling af kæber, mundhule og svælg
BEGA0	Ekstern strålebehandling af læber
BEGA1	Ekstern strålebehandling af mundhule
BEGA2	Ekstern strålebehandling af svælg
BEGA3	Ekstern strålebehandling af spytkirtel
BEGA4	Ekstern strålebehandling af kæber
BEH	Med.beh.med virk.på lidelser i tænder,kæber,mund og svælg
BEHL	Cytostatisk beh. med relation til kæber, mundhule og svælg
BEHL0	Cytostatisk behandling af kæber, mundhule og svælg
BEHL01	Cytostatisk behandling af mundslimhinde
BEHL02	Cytostatisk behandling af spytkirtel
BEHO	Injektionsbehandling af lidelser i kæbeled og tyggemuskler
BEHO0	Injektionsbehandling af kæbeled
BEHO00	Injektionsbehandling af kæbeled med analgeticum
BEHO01	Injektionsbehandling af kæbeled med glucokortikoid
BEHO02	Injektionsbehandling af kæbeled med autologt blod
BEHO03	Injektionsbehandling af kæbeled med hyaluronsyre
BEHO1	Injektionsbehandling af tyggemuskler
BEHO10	Injektionsbehandling af tyggemuskler med analgeticum
BEHO11	Injektionsbehandling af tyggemuskler med glocokortikoid
BEHO12	Injektionsbehandling af tyggemuskler med botulinum
BEHR	Medikamentel behandling af tænder, kæber, mund og svælg
BEHR0	Medikamentel lokalbehandling af mundhule og svælg
BEHR00	Medikamentel lokalbehandling af læber
BEHR01	Medikamentel lokalbehandling af mundslimhinde
BEHR02	Medikamentel lokalbehandling af svælg
BEHR03	Medikamentel lokalbehandling af parodontium
BEHY	Med.beh.af lidelse i mundhule og svælg ikke klass.andetsteds
BEK	Pædagogiske interventioner vedrørende tand- og mundpleje
BEKA	Instruktion i mundhygiejne
BEKA0	Instruktion i tandpleje
BEKA00	Instruktion i tandbørstning
BEKA01	Instruktion i fluorskylning
BEN	Behandling af lidelser i kæbeled og tyggemuskler
BENA	Behandling af kæbeled og tyggemuskler med bidskinne
BENA0	Behandling af kæbeled  med bidskinne
BENA00	Aftryk til bidskinne ved behandling af kæbeled
BENA01	Tilpasning af bidskinne ved behandling af kæbeled
BENA1	Behandling af tyggemuskler med bidskinne
BENA10	Aftryk til bidskinne ved behandling af tyggemuskler
BENA11	Tilpasning af bidskinne ved behandling af tyggemuskler
BEO	Behandling af tænder
BEOA	Behandling med tandfyldning, krone, bro mm.
BEOA0	Behandling med tandfyldning
BEOA00	Behandling med sølvamalgamfyldning
BEOA01	Behandling med plastfyldning
BEOA02	Behandling med glasiomercementfyldning
BEOA1	Behandling med indlæg, krone og bro
BEOA10	Behandling med indlæg
BEOA11	Behandling med krone
BEOA12	Behandling med bro
BEOA5	Behandling med foreløbig tandfyldning
BEOA6	Overdækning af dentinflader ved tandfraktur
BEOB	Rodbehandling
BEOB0	Overkapning
BEOB1	Koronal amputation
BEOB2	Pulpaextirpation
BEOB3	Ortograd rodfyldning
BEOB4	Retrograd rodfyldning
BEOB5	Skift af rodfyldning
BEOE	Beslibning af tænder
BEOE0	Okklusions- og artikulationsslibning af tænder
BEOG	Intermaxillær fiksation
BEOG0	Anlæggelse af elastisk intermaxillær fiksation
BEOG1	Anlæggelse af stiv intermaxillær fiksation
BEOG5	Fjernelse af fiksationsmateriale fra tænder
BEOG6	Fjernelse af  intermaxillær fiksation
BEOG7	Fjernelse af  intermaxillære fiksationsskinner
BEOL	Tandbehandling med skinner
BEOL0	Behandling med beskyttelsesskinne
BEP	Tandregulering
BEPA	Regulering af tænder
BEPA0	Regulering af tænder med fast apparatur
BEPA1	Regulering af tænder med aftageligt apparatur
BEX	Andre interv. med rel.til tænder, kæber, mund og svælg
BEXC	Parodontalbehandling
BEXC0	Tandrensning
BEXY	Interv.med rel.til tænder,kæber,mund og svælg ikke klass.a.s
BEXY0	Aftryk til modeller
BEXY9	Odontologisk behandling ikke klassificeret andetsteds
BF	Hjerte og store kar
BFC	Behandling med kardial pacemaker og cardioverter-defibrillat
BFCA	Procedurer i forbindelse med kardial pacemakerbehandling
BFCA0	Implantation af transvenøs kardial pacemaker
BFCA01	Implant.af transvenøs kardial pacemaker med ventr. elektrode
BFCA02	Implant.af transvenøs kardial pacemaker med atrial elektrode
BFCA03	Implant.af transvenøs kardial pacemaker med atr.og ventr.ele
BFCA04	Implant.af transvenøs multi-site kardial pacemaker m.atri.el
BFCA05	Implant.af transvenøs multi-site kardial pacemaker m.ventr.e
BFCA06	Implant.af transvenøs multi-site kardial pacemaker m.elek.i
BFCA07	Implantation af VDD pacemaker
BFCA1	Udskiftning af kardial pacemaker
BFCA10	Udskiftning af kardial pacemaker - 1-kammer
BFCA11	Udskiftning af kardial pacemaker - 2-kammer
BFCA12	Udskiftning af kardial pacemaker - anden
BFCA2	Opgradering af kardial pacemaker
BFCA20	Opgrad.af kardial pacemaker inkl.suppl.elekt.til 2-kammer fu
BFCA21	Opgrad.af kardial pacemaker inkl.suppl.elekt.til multi-site
BFCA3	Revision af pacemaker
BFCA30	Revision og flytning af kardial pacemaker
BFCA31	Revision og forsænkning af kardial paceelektrode
BFCA4	Fjernelse af kardial pacemaker
BFCA5	Behandling med loop recorder
BFCA50	Implantation af loop recorder
BFCA51	Fjernelse af loop recorder
BFCA6	Implantation af transvenøs kardial paceelektrode
BFCA7	Replacering af disloceret paceelektrode
BFCA70	Replac.af disloceret transvenøst anlagt atr.paceelektrode
BFCA71	Replac.af disloceret transvenøst anlagt ventr.paceelektrode
BFCA8	Ekstraktion af transvenøs paceelektrode
BFCA80	Ekstraktion af transvenøs paceelektrode, simpel (antal)
BFCA81	Ekstraktion af transvenøs paceelektrode, laserteknik (antal)
BFCA82	Ekstraktion af transvenøs paceelektrode, sheath-system (anta
BFCA9	Anlæggelse af temporær transvenøs paceelektrode
BFCA90	Anlæggelse af temporær transvenøs paceelektrode - 1-kammer
BFCA91	Anlæg.af temporære transvenøse paceelektroder - 2-kammer
BFCB	Procedurer i forbindelse med cardioverter-defibrillator beh.
BFCB0	Implantation af cardioverter-defibrillator
BFCB00	Implant.af cardiovert.-defibrill.til ventr.takykardi,1-kamme
BFCB01	Implant.af cardiovert.-defibrill.til ventr.takykardi,2-kamme
BFCB02	Implantation af cardioverter-defibrillator til atrieflimren
BFCB03	Implantation af cardioverter-defibrillator - multisite
BFCB2	Opgradering af cardioverter-defibrillator
BFCB20	Opgrad.af cardiovert.-defibrill.inkl.suppl.elektr.til 2-kamm
BFCB21	Opgrad.af cardiovert.-defibrill.inkl.supp.elekt.til multi-si
BFCB3	Revision af cardioverter-defibrillator
BFCB30	Revision og flytning af cardioverter-defibrillator
BFCB31	Revision og forsænkning af cardioverter-defibrillator elektr
BFCB4	Fjernelse af cardioverter-defibrillator
BFCB5	Udskiftning af cardioverter-defibrillator
BFCB50	Udskiftning af cardioverter-defibrillator - 1-kammer funktio
BFCB51	Udskiftning af cardioverter-defibrillator - 2-kammer funktio
BFCB52	Udskiftning af cardioverter-defibrillator - til atrieflimren
BFCB53	Udskiftning af cardioverter-defibrillator - multi-site
BFCB6	Implantation af cardioverter-defibrillator elektrode
BFCB60	Implant.af suppl.vena cava-elektrode til cardioverter-defibr
BFCB61	Implant.af suppl.subkutan elektrode til cardioverter-defibri
BFCB62	Implant.af epikardial patch-elektrode til cardioverter-defib
BFCB63	Impl.af suppl. sense elektr. til cardioverter-defribrillator
BFCB7	Replacering af disloceret cardioverter-defibrillator elektro
BFCB8	Ekstraktion af cardioverter-defibrillator elektrode
BFCB80	Ekstrakt.af cardioverter-defibrillator elektrode, simpel
BFCB81	Ekstrakt.af cardioverter-defibrillator elektrode, lasertekni
BFCB82	Ekstrakt.af cardioverter-defibrill.elektrode, sheath-system
BFCY	Procedure i forb.m.kardial pacemakerbehandling ikke klass.a.
BFCY0	Zoll pacing
BFF	Andre behandlinger ved kardiale rytmeforstyrrelser
BFFA	Eksternt anvendt procedure ved beh.af kardiale rytmeforstyrr
BFFA0	Defibrillering og konvertering
BFFA00	Ekstern DC-konvertering
BFFA01	Cardioversio DC synchronisata
BFFA03	Defibrillatio ventriculorum asynchronisata
BFFA04	Defibrillatio atriorum DC synchronisata
BFFA05	Transvenøs DC-konvertering
BFFA6	Hjertemassage
BFFA60	Ekstern hjertemassage
BFFA61	Åben (intern) hjertemassage
BFFB	Radiofrekvensablation
BFFB0	Radiofrekvensablation ved atrielle rytmeforstyrrelser
BFFB00	Radiofrekvensablation m.h.p.sinusknude modifikation
BFFB01	Radiofrekvensablation ved fokal atrial takykardi
BFFB02	Radiofrekvensablation ved incessant atrial takykardi
BFFB03	Radiofrekvensablation ved fluctuatio atriorum
BFFB04	Radiofrekvensablation ved fibrillatio atriorum
BFFB1	Radiofrekvensablation ved Wolff-Parkinson-White syndrom
BFFB10	Radiofrekvensabl.via hø.ventr.ved Wolff-Parkinson-White synd
BFFB11	Radiofrekvensabl.retrogradt via ve.ventr.Wolff-Park.-White s
BFFB12	Radiofrekvensabl.transseptalt ved Wolff-Parkinson-White synd
BFFB2	Radiofrekvensablation ved atrioventrikulære rytmeforstyrrels
BFFB20	Radiofrekvensabl.ved atrioventr.nodal re-entrytakykardi via
BFFB21	Radiofrekvensabl.ved atrioventr.nodal re-entrytakykardi via
BFFB22	Radiofrekvensabl.m.h.p. atrioventrikulær knude modifikation
BFFB23	Radiofrekvensabl.ved permanent junctional re-entry takykardi
BFFB3	Radiofrekvensablation af His bundt
BFFB30	Radiofrekvensablation af His bundt via højre ventrikel
BFFB31	Radiofrekvensablation af His bundt via venstre ventrikel
BFFB4	Radiofrekvensablation ved ventrikulære rytmeforstyrrelser
BFFB40	Radiofrekvensabl.ved takykard.og ekstrasyst.ventr.i hø.ventr
BFFB41	Radiofrekvensabl.ved takykard.og ekstrasyst.ventr.i ø.ventr.
BFFB42	Radiofrekvensablation ved Gallavardin´s ventr. takykardi
BFFB43	Radiofrekvensabl.ved takykard.og ekstrasyst.ventr.i ve.ventr
BFFB5	Radiofrekvensablation ved rytmeforstyrrelser ikke klass.a.st
BFFB50	Radiofrekvensabl.via hø.ventr.ved rytmeforstyr.ikke klass.a.
BFFB51	Radiofrekv.abl.retrogr.via ve.ventr.ved ledn.forstyr.ikke kl
BFFB52	Radiofrekv.abl.transsept.via ve ventr.ved rytmeforst.ikke kl
BFH	Medikamentel behandling af kredsløbslidelser
BFHC	Medikamentel hjerteterapi
BFHC0	Behandling med antihypertensivum
BFHC1	Behandling med diureticum
BFHC2	Behandling med ?-receptorblokerende middel
BFHC3	Behandling med calcium antagonist
BFHC4	Behandling med nitrater
BFHC5	Behandling med ACE-hæmmende middel
BFHC6	Behandling med lipidsænkende middel
BFHC9	Medikamentel hjerteterapi ikke klassificeret andetsteds
BFHC90	Behandling med hjerteglykosid
BFHC91	Behandling med antiarytmikum
BFHC92	Behandling med hjertestimulerende middel
BFHC93	Behandling med blodtryksforhøjende middel
BFHC94	Behandling med pladehæmmer
BFK	Pædagogiske intervent. vedr. lidelser i hjerte og store kar
BFKA	Vejl. i fysisk aktivitet efter lidelse i hjerte og store kar
BFX	Andre interventioner med relation til kredsløbssygdomme
BFXA	Specificeret intervention med relation til kredsløbssygdom
BFXA0	Behandling af kredsløbssvigt ved speciel lejring
BFXA00	Trendelenburg-lejring
BFXY	Intervention med rel.til kredsløbssygdom ikke klass.andetste
BFXY0	Behandling med aorta-ballonpumpe
BG	Brysthule, lunger og respiration
BGA	Behandling med sonde og tube i brysthule og luftveje
BGAG	Behandling med tube i luftveje
BGAG0	Behandling med tungeholder
BGAG1	Behandling med oraltube
BGAG2	Behandling med nasaltube
BGAG3	Behandling med trakealtube
BGAG4	Behandling med trakealkanyle
BGAZ	Delprocedurer med relation til behandling med tube i luftvej
BGAZ0	Anlæggelse af tube i luftveje
BGAZ00	Anlæggelse af tungeholder
BGAZ01	Anlæggelse af oraltube
BGAZ02	Anlæggelse af nasaltube,
BGAZ03	Anlæggelse af trakealtube
BGAZ1	Skiftning af tube i luftveje
BGAZ11	Skiftning af oraltube
BGAZ12	Skiftning af nasaltube
BGAZ13	Skiftning af trakealtube
BGAZ14	Skiftning af trakealkanyle
BGAZ2	Fjernelse af tube i luftveje
BGAZ20	Fjernelse af tungeholder
BGAZ21	Fjernelse af oraltube
BGAZ22	Fjernelse af nasaltube
BGAZ23	Fjernelse af trakealtube
BGAZ24	Fjernelse af trakealkanyle
BGD	Behandling med respirator mm.
BGDA	Respiratorbehandling og anden assisteret ventilation
BGDA0	Respiratorbehandling
BGDA00	PEEP-behandling med respirator
BGDA6	Ventilation
BGDA60	Manuel ventilation med maske
BGDA61	Manuel ventilation gennem trakealtube
BGDA62	Mund-til-næse ventilation
BGDA63	Mund-til-mund ventilation
BGDA7	Tilslutning af patient til respirator
BGF	Interventioner ved behandling af respirationslidelser
BGFC	Lungeterapi og anden respirationsbehandling
BGFC0	Lungeterapi med fokus på vitalkapacitet
BGFC00	Diafragmatiske respirationsøvelser
BGFC01	Latero-basale respirationsøvelser
BGFC02	Mobilisering til forbedring af vitalkapacitet
BGFC03	Styrke- og konditionstræning med fokus på vitalkapacitet
BGFC04	Mobiliserende øvelser for thorax til forbedring af vitalkapa
BGFC05	Manuel stimulation af thorax med fokus på vitalkapacitet
BGFC06	Respirationsmuskeltræning (RMT)
BGFC07	Indøvning af hvilestillinger med fokus på vitalkapacitet
BGFC1	Lungeterapi ved sekretproblemer
BGFC10	Indøvning af støde- og hosteteknik
BGFC11	Drænage og stillingsændringer ved sekretproblemer
BGFC12	'Pursed lip-breathing' ved sekretproblemer
BGFC13	Behandling af sekretproblemer med vibrationer
BGFC14	Behandling af sekretproblemer med tapotement
BGFC15	Behandling af sekretproblemer med squeezing
BGFC16	Behandling af sekretproblemer med mobilisering
BGFC3	Maskebehandling
BGFC30	PEP-behandling
BGFC31	CPAP-behandling, konventionel metode
BGFC32	Nasal CPAP-behandling
BGFC33	PEEP-behandling med maske
BGFC34	BiPAP-behandling
BGFC7	Kompenserende støttehandling ved respirationsproblemer
BGFC70	Kompens.støttehandl.mhp. korrekt lejr.ved respirationsprobl.
BGFC71	Elevation af hovedgærde ved vejrtrækningsproblemer
BGG	Strålebehandling med relation til organer i brysthule
BGGA	Strålebehandling af nedre luftveje, lunger og mediastinum
BGGA0	Strålebehandling af lunger
BGGA1	Strålebehandling af mediastinum
BGGA2	Strålebehandling af nedre luftveje
BGH	Medikamentel behandling af luftvejslidelser
BGHF	Behandling med lungemodnende middel
BGHL	Cytostatisk beh. af nedre luftveje, lunger og mediastinum
BGHL0	Cytostatisk behandling af lunger
BGHL1	Cytostatisk behandling af nedre luftveje
BGHR	Medikamentel behandling af respirationslidelser
BGHR0	Medikamentel behandling af astma
BGHR00	Bronkodilaterende medikamentel behandling af astma
BGHR01	Forebyggende medikamentel behandling af astma
BGHR1	Behandling af hoste
BGHR10	Behandling med hostestillende middel
BGHR11	Behandling med slimløsnende middel
BGHR9	Med.beh.af respirationslidelse ikke klass.andetsteds
BGK	Pædagogiske interventioner vedrørende respirationslidelser
BGKA	Instruktion i ekspektoratopsamling
BGKB	Instruktion i hvilestilling ved respirationsbesvær
BGKC	Vejledning vedr. behandling af astma og kol
BGKC0	Vejledning vedr. behandling af astma og kol med tabletter
BGKC1	Vejledning vedr. behandling af astma og kol med inhalation
BGKC2	Vejledning vedr. forebyggende  behandling af astma og kol
BGKC3	Vejledning vedr. bronkieudvid.  behandling af astma og kol
BGKD	Vejledning i peak flow monitorering
BGKF	Vejledning i vurdering af egen respirationsfunktion
BGKG	Vejledning af patient med respirationslidelse pga. allergi
BGKG0	Vejledning af patient om støvsanering
BGKG1	Vejledning af patient om indeklimaproblemer
BGKG2	Vejledning af patient om pollenallergi
BGKH	Vejledning af patient om iltbehandling
BGKI	Vejledning af patient om CPAP-behandling
BGL	Soignering mm. med relation til luftveje
BGLF	Soignering af tube og stomi med relation til luftveje
BGLF1	Soignering af oraltube
BGLF2	Soignering af nasaltube
BGLF3	Soignering af trakealtube
BGLF4	Soignering af trakeostomi
BGM	Interventioner med relation til ekspektoration
BGME	Interventioner ved sekretion fra luftveje
BGME0	Sugning af øvre luftveje
BGME1	Sugning af nedre luftveje
BGME10	Trakealsugning
BGME11	Trakealsugning gennem tube
BGME12	Trakealsugning gennem kanyle
BGME5	Kompenserende støtte ved ekspektoration
BGX	Andre interv.med rel.til brysthule, lunger og respiration
BGXA	Spec.interv.med rel.til brysthule, lunger og respiration
BGXA0	Hyperventilationsbehandling
BGXA1	Fugterbehandling
BGXA10	Behandling med forstøver
BGXA2	Ekstrakorporal membran oxygenering (ECMO)
BGXA5	Iltbehandling
BGXA50	Iltbehandling med nasalkateter
BGXA51	Iltbehandling med maske
BGXA52	Iltbehandling med tragt
BGXA53	Iltbehandling i ilttelt
BGXA54	Iltbehandling i kuvøse
BGXA55	Iltbehandling gennem trakealkanyle
BGXA6	Hyperbar iltbehandling
BGXA8	Teknisk service knyttet til iltbehandling
BGXA80	Udskiftning af iltbeholder ved iltbehandling
BGXY	Interv.med rel.til brysthule, lunger og resp.ikke klass.a.st
BH	Mamma
BHD	Behandling med brystprotese
BHDD	Behandling med ekstern brystprotese
BHG	Strålebehandling med relation til mamma
BHGA	Strålebehandling af mamma
BHH	Medikamentel behandling af lidelse i mamma
BHHH	Hormonel behandling af mamma
BHHK	Antihormonel behandling af mamma
BHHL	Cytostatisk behandling af mamma
BHK	Pædagogiske interventioner vedrørende mamma
BHKA	Instruktion i brug af brystprotese
BHKB	Instruktion af øvelser efter brystoperation
BHY0	Med.beh.af metabolisk knoglesygdom ikke klass.andetsteds
BI	Mave-tarmkanal
BIA	Behandling med sonder ved lidelser i mave-tarmkanalen
BIAD	Behandling med gastro-intestinal sonde
BIAD0	Behandling med nasalsonde til ventrikel og duodenum
BIAD1	Behandling med nasalsonde til jejunum
BIAD3	Behandling med Sengstaken-sonde
BIAD30	Skylning af ventrikel gennem Sengstaken-sonde
BIAD31	Ophævelse af kompression med Sengstaken-sonde
BIAD32	Desufflering af oesophagusballon på Sengstaken-sonde
BIAD33	Desufflering af ventrikelballon på Sengstaken-sonde
BIAD5	Beh.med sonde til ventr. og duodenum ikke klass.a.st.
BIAD7	Behandling med rektalsonde
BIAZ	Delprocedurer ved behandling med gastro-intestinal sonde
BIAZ0	Anlæggelse af gastro-intestinal sonde
BIAZ00	Anlæggelse af nasalsonde til ventrikel og duodenum
BIAZ01	Anlæggelse af nasalsonde til jejunum
BIAZ03	Anlæggelse af Sengstaken-sonde
BIAZ05	Anlæggelse af sonde til ventrikel og duodenum ikke klass.a.s
BIAZ07	Anlæggelse af rektalsonde
BIAZ1	Skiftning af gastro-intestinal sonde
BIAZ10	Skiftning af nasalsonde til ventrikel og duodenum
BIAZ11	Skiftning af nasalsonde til jejunum
BIAZ13	Skiftning af Sengstaken-sonde
BIAZ15	Skiftning af sonde til ventrikel og duodenum ikke klass.a.st
BIAZ2	Fjernelse af gastro-intestinal sonde
BIAZ20	Fjernelse af nasalsonde til ventrikel og duodenum
BIAZ21	Fjernelse af nasalsonde til jejunum
BIAZ23	Fjernelse af Sengstaken-sonde
BIAZ25	Fjernelse af sonde til ventrikel og duodenum ikke klass.a.st
BIAZ27	Fjernelse af rektalsonde
BIB	Beh.af lidelse i mave-tarmkanal med perkut.katetre,sonder og
BIBG	Behandling med perkutane sonder og dræn til fordøjelses-kana
BIBG0	Behandling med gastrostomisonde
BIBG1	Behandling med jejunostomi-sonde
BIBG2	Behandling med galdevejsdræn
BIBG3	Behandling med jejunumsonde via gastrostomi
BIBZ	Delprocedure ved beh.m.perkut.sonder/dræn til mave-tarmkanal
BIBZ0	Anlæggelse af sonde og dræn til mave-tarmkanalen
BIBZ00	Anlæggelse af gastrostomisonde
BIBZ01	Anlæggelse af jejunostomi-sonde
BIBZ03	Anlæggelse af  jejunumsonde via gastrostomi
BIBZ1	Skiftning af sonde og dræn til mave-tarmkanalen
BIBZ10	Skiftning af gastrostomisonde
BIBZ11	Skiftning af jejunostomi-sonde
BIBZ13	Skiftning af jejunumsonde via gastrostomi
BIBZ2	Fjernelse af sonde og dræn til mave-tarmkanalen
BIBZ20	Fjernelse af gastrostomisonde
BIBZ21	Fjernelse af jejunostomi-sonde
BIBZ22	Fjernelse af galdevejsdræn
BIBZ23	Fjernelse af jejunumsonde via gastrostomi
BID	Bandagebeh. med eksterne bandager ved mave-tarmsygdomme
BIDA	Bandagebehandling ved stomi
BIDA0	Behandling med stomibandage
BIDA1	Bandagebehandling ved stomibrok
BIG	Strålebehandling med relation til fordøjelsesorganer
BIGA	Strålebehandling af mave-tarmkanal
BIGA0	Strålebehandling af oesophagus
BIGA1	Strålebehandling af ventrikel
BIGA2	Strålebehandling af colon
BIGA3	Strålebehandling af rectum og anus
BIGC	Strålebehandling af lever
BIGE	Strålebehandling af gladeblære og galdeveje
BIGG	Strålebehandling af pancreas
BIH	Med. behandling m relation til lidelser i fordøjelsesorganer
BIHA	Medikamentel behandling af lidelse i mave-tarmkanal
BIHA0	Medikamentel behandling af lidelse i ventrikel og duodenum
BIHA00	Behandling med H2-receptorantagonist
BIHA01	Behandling med syrepumpehæmmer
BIHA02	Behandling med mucosaprotektivt middel
BIHA03	Eradikationsbehandling
BIHA04	Behandling med antirefluksmiddel
BIHA05	Behandling med syreneutraliserende middel
BIHA1	Medikamentel behandling af lidelse i tynd- og tyktarm
BIHA10	Behandling med tarmantiinflammatorikum
BIHA11	Behandling med glukokortikoidholdigt klysma
BIHA2	Medikamentel behandling af pancreaslidelse
BIHA8	Anden specificeret medikamentel beh. af mave-tarmlidelse
BIHA80	Behandling med middel mod diarrhoe
BIHA81	Behandling med laksantium
BIHA82	Behandling med anoreksikum
BIHL	Cytostatisk behandling af mave-tarmkanal
BIHL0	Cytostatisk behandling af oesophagus
BIHL1	Cytostatisk behandling af ventrikel
BIHL2	Cytostatisk behandling af colon
BIHL3	Cytostatisk behandling af rectum og anus
BIHL4	Cytostatisk behandling af lever
BIHL5	Cytostatisk behandling af galdeblære og galdeveje
BIHL6	Cytostatisk behandling af pancreas
BIK	Pædagogiske interventioner vedrørende mave-tarmkanalen
BIKA	Vejledning i pleje af stomi
BIKA0	Vejledning i valg af stomibandage
BIKB	Instruktion i stomipasning
BIKB0	Instruktion i irrigation i stomi
BIKC	Vejledning i særlige forhold for stomipatient
BIKC0	Vejledning ved seksuelle problemer for stomipatient
BIKC1	Vejledning ved sociale problemer for stomipatient
BIKD	Vejledning i fæcesopsamling
BIKH	Vejledning til levertransplanteret patient
BIL	Soignering af sonder/katetre med rel.til mave-tarmkanalen
BILF	Soignering af sonde i mave-tarmkanalen og enterostomi
BILF0	Soignering af sonde til ventrikel og duodenum
BILF01	Soignering af nasalsonde til ventrikel og duodenum
BILF1	Soignering af gastrostomisonde
BILF2	Soignering af jejunostomi-kateter
BILF3	Soignering af ileostomi
BILF4	Soignering af kolostomi
BILF6	Soignering af galdevejsdræn
BIM	Tømning, stomipleje mm. med relation til mave-tarmkanalen
BIMA	Ventrikeltømning
BIMA0	Ventrikelaspiration
BIMA00	Ventrikelaspiration ved permanent sug
BIMA01	Manuel ventrikelaspiration
BIMA1	Kompenserende støtte ved opkastning
BIMB	Manuel udhentning af fekalia
BIMZ	Delprocedurer ved enterostomibehandling
BIMZ0	Påsætning af enterostomipose
BIMZ00	Påsætning af ileostomipose
BIMZ01	Påsætning af kolostomipose
BIMZ1	Tømning af enterostomipose
BIMZ10	Tømning af ileostomipose
BIMZ11	Tømning af kolostomipose
BIMZ2	Fjernelse af enterostomipose
BIMZ20	Fjernelse af ileostomipose
BIMZ21	Fjernelse af kolostomipose
BIMZ5	Irrigation af enterostomi
BIX	Andre interventioner i relation til mave-tarmkanalen
BIXA	Procedurer vedrørende sekretion
BIXA0	Pleje af dræn
BIXA00	Skylning af dræn
BIXA01	Afkortning af dræn
BIXA1	Anvendelse af drænpose
BIXA2	Anvendelse af drænsug
BIXB	Irrigation af endetarmsstump
BIXY	Intervention med rel.til mave-tarmkanalen ikke klass.andetst
BIXY0	Colonmassage
BIXY5	Markering af stomisted
BIXZ	Delprocedurer ved behandling med dræn
BIXZ0	Påsætning af drænposer og drænsug
BIXZ00	Påsætning af drænpose
BIXZ01	Etablering af drænsug
BIXZ1	Skiftning og tømning af drænposer og drænsug
BIXZ10	Skiftning og tømning af drænpose
BIXZ11	Skiftning og tømning af drænsug
BIXZ2	Fjernelse af dræn, drænposer og drænsug
BIXZ20	Fjernelse af dræn
BIXZ21	Fjernelse af drænpose
BIXZ22	Fjernelse af drænsug
BJ	Nyrer, urinveje og kønsorganer
BJA	Behandling med blærekateter
BJAA	Blærekateterisation
BJAA0	Éngangskaterisation af blæren
BJAA00	Éngangskaterisation af blæren (kvinde)
BJAA01	Éngangskaterisation af blæren (mand)
BJAA1	Behandling med blærekateter a demeure
BJAA10	Skylning af blærekateter a demeure
BJAZ	Delprocedurer ved behandling med blærekateter
BJAZ0	Anlæggelse af blærekateter
BJAZ00	Anlæggelse af blærekateter a demeure (kvinde)
BJAZ01	Anlæggelse af blærekateter a demeure (mand)
BJAZ1	Skiftning af blærekateter
BJAZ10	Skiftning af blærekateter a demeure (kvinde)
BJAZ11	Skiftning af blærekateter a demeure (mand)
BJAZ2	Fjernelse af blærekateter
BJAZ20	Fjernelse af blærekateter a demeure (kvinde)
BJAZ21	Fjernelse af blærekateter a demeure (mand)
BJC	Antikonception
BJCD	Intrauterin antikonception
BJCD0	Antikonception med spiral
BJCE	Vaginal antikonception
BJCE0	Pessar til antikonception
BJCE1	Antikonception med vaginalt kondom
BJCF	Antikonception med mandligt kondom
BJCZ	Delprocedure ved antikonception
BJCZ0	Indlæggelse af spiral
BJCZ00	Indlæggelse af spiral med kobber
BJCZ01	Indlæggelse af spiral med hormon
BJCZ02	Indlæggelse af anden spiral
BJCZ07	Indlæggelse af vaginalpessar (antikonception)
BJCZ2	Fjernelse af spiral
BJCZ7	Måltagning til vaginalpessar (antikonception)
BJD	Prolapsbehandling med hjælpemidler
BJDA	Behandling med vaginalring
BJDA0	Vaginalringsbehandling
BJDY	Prolapsbehandling med hjælpemidler ikke klassificeret andets
BJDZ	Delprocedure ved prolapsbehandling med hjælpemidler
BJDZ0	Indlæggelse af vaginalring
BJDZ1	Skiftning af vaginalring
BJDZ7	Måltagning til vaginalring
BJF	Behandling af dysfunktioner i nyrer, urinveje og kønsorganer
BJFA	Inkontinensbehandling
BJFA0	Elstimulationsbehandling ved inkontinens
BJFA1	Træning ved inkontinens
BJFA10	Træning af vandladningsvaner ved inkontinens (blæretræning)
BJFA11	Træning af bækkenbundsmuskulatur ved inkont.(bækkenbundstræn
BJFD	Dialysebehandling
BJFD0	Akut dialyse
BJFD00	Akut hæmodialyse
BJFD01	Akut peritonealdialyse
BJFD02	Kontinuerlig vene-vene-diahæmofiltration (CVVDHF)
BJFD2	Kronisk dialyse
BJFD20	Kronisk hæmodialyse
BJFD21	Kronisk peritonealdialyse, CAPD
BJFD22	Kronisk peritonealdialyse IPD
BJFF	Behandling ved nyre- og blærelidelser ikke klass.andetsteds
BJFF0	Forceret diurese
BJFF1	Blærekompression
BJFF2	Blæretapotement
BJFL	Behandling af dysfunktioner i kønsorganer
BJFL0	Fertilitetsbehandling
BJFL00	Fertilisatio in vitro (IVF)
BJFL01	ICSI
BJFL09	Assiteret fertilisering ikke klassificeret andetsteds
BJFL3	Insemination
BJFL30	Insemination med sæd fra partner
BJFL31	Insemination med sæd fra donor
BJFL6	Andrologisk behandling
BJFL60	Erectio artificialis
BJFZ	Delprocedurer ved dialysebehandling
BJFZ0	Tilslutning af dialyseapparatur til patient
BJFZ00	Tilslutning af hæmodialyseapparatur til patient
BJFZ01	Tilslutning af peritonealdialyseapparatur til patient
BJFZ1	Fjernelse af dialyseapparatur fra patient
BJFZ10	Fjernelse af hæmodialyseapparatur fra patient
BJFZ11	Fjernelse af peritonealdialyseapparatur fra patient
BJFZ5	Procedure vedrørende dialysekateter
BJFZ50	Skift af hæmodialysekateter
BJFZ51	Skylning af hæmodialysekateter
BJFZ52	Skift af peritonaldialysekateter
BJFZ53	Skylning af peritonaldialysekateter
BJG	Strålebeh. med relation til nyrer, urinveje og kønsorganer
BJGA	Strålebehandling af nyrer, urinveje og kønsorganer
BJGA0	Strålebehandling af nyrer
BJGA1	Strålebehandling af urinveje
BJGA12	Strålebehandling af urinblære
BJGA2	Strålebehandling af kønsorganer
BJGA20	Strålebehandling af livmoder
BJGA21	Strålebehandling af prostata
BJGA22	Strålebehandling af testes
BJGA23	Strålebehandling af ovarier
BJGF	Strålebehandling af bækken
BJH	Medikam.beh. med rel.til nyrer, urinveje og kønsorganer
BJHA	Medikamentel peroral behandling af elektrolytforstyrrelser
BJHA0	Peroral behandling af elektrolytforstyrrelser
BJHE	Medikamentel behandling af blærelidelse
BJHE0	Medikamentel behandling af blærespasmer
BJHE1	Installation af lægemiddel i blæren
BJHF	Medikamentel behandling af manglende erektion
BJHG	Medikamentel gynækologisk lokalbehandling
BJHG0	Gynækologisk lokalbeh. med antibiotikum og antiseptikum
BJHG00	Behandling med antibakterielt vaginalmiddel
BJHG01	Behandling med antiviralt vaginalmiddel
BJHG02	Behandling med antimykotisk vaginalmiddel
BJHG03	Behandling med vaginalmiddel mod protozoer
BJHG1	Antikonception med kemisk middel
BJHK	Antihormonel behandling af prostata
BJHL	Cytostatisk behandling af nyrer, urinveje og kønsorganer
BJHL0	Cytostatisk behandling af nyrer
BJHL1	Cytostatisk behandling af urinveje
BJHL10	Installation af cytostatika i urinblære
BJHL11	Installation af BCG i urinblære
BJHL2	Cytostatisk behandling af kønsorganer
BJHL20	Cytostatisk behandling af livmoder
BJHL21	Cytostatisk behandling af prostata
BJHL22	Cytostatisk behandling af testes
BJHL23	Cytostatisk behandling af ovarier
BJK	Pædagogiske interventioner vedr.beh.af urin og kønsorganer
BJKA	Pædagogiske handl.vedr. behandling af urininkontinens
BJKA0	Vejledning og undervisning til inkontinenspatient
BJKA00	Undervisning i blærefunktion
BJKA01	Miktionsrådgivning
BJKA02	Vejledning og undervisning i selvkateterisation
BJKA1	Rådgivning om hjælpemidler til inkontinenspatient
BJKA10	Rådgivning om brug af drypbind
BJKA11	Rådgivning om brug af urinbind
BJKA12	Rådgivning om brug af penisklemme
BJKA13	Rådgivning om brug af vaginaltampon
BJKA14	Rådgivning om brug af vaginalvægte
BJKB	Pædagogiske handlinger i relation til dialyse
BJKB0	Oplæring i brug af kronisk peritonealdialyse, CAPD
BJKB1	Oplæring i brug af maskine til peritonealdialyse
BJKD	Pædagogiske handlinger vedrørende antikonception
BJKD0	Vejledning vedrørende antikonception
BJKD00	Vejledning vedrørende hormonel antikonception
BJKD01	Vejledning vedrørende antikonception med vaginalt pessar
BJKD02	Vejledning vedrørende antikonception med vaginalt kondom
BJKD03	Vejledning vedrørende antikonception med kondom
BJKD04	Vejledning vedrørende antikonception med spiral
BJKD05	Vejledning vedrørende antikonception med kemiske midler
BJKE	Pædagogiske handlinger vedrørende impotens
BJKE0	Vejledning vedrørende impotensbehandling
BJKF	Pædagogiske handlinger vedrørende fertilitet
BJKF0	Vejledning vedrørende fertilitetsbehandling
BJKF1	Rådgivning vedrørende fetilitet/infertilitet
BJKY	Pædagog.handl.ved beh.af urin- og kønsorganer ikke klass.a.s
BJKY0	Vejledning i urinopsamling
BJL	Soignering mm. i relation til urinveje og kønsorganer
BJLA	Soignering af kateter og urostomi
BJLA0	Soignering af blærekateter
BJLA1	Soignering af urostomi
BJLA10	Soignering af cystostomi
BJLA11	Soignering af ureterostomi
BJLA12	Soignering af urethrastomi
BJLA13	Soignering af nefrostomi
BJLA14	Soignering af urinafledende enterostomi
BJLC	Skylning af vagina
BJLC0	Vaginalskylning
BJLD	Soignering af vaginalring
BJM	Intervent.ved vandladning og urinudtømning gennem urostomi
BJMC	Kompenserende handling mhp. urinudtømning
BJMC0	Komp. handling mhp. anv. af hjælpemiddel ved vandladning
BJMC00	Kompenserende handling mhp. anvendelse af uridom
BJMC01	Kompenserende handling mhp. anvendelse af dryppose
BJMC02	Kompenserende handling mhp. anvendelse af urinpose
BJMC03	Kompenserende handling mhp. anvendelse af uretraprop
BJML	Pleje af urostomi
BJMZ	Delprocedurer ved behandling og pleje af urostomi
BJMZ0	Påsætning af urostomipose
BJMZ00	Påsætning af cystostomipose
BJMZ01	Påsætning af nefrostomipose
BJMZ02	Påsætning af ureterostomipose
BJMZ03	Påsætning af urethrastomipose
BJMZ04	Påsætning af pose på urinafledende enterostomi
BJMZ1	Skiftning af urostomipose
BJMZ10	Skiftning af cystostomipose
BJMZ11	Skiftning af nefrostomipose
BJMZ12	Skiftning af ureterostomipose
BJMZ13	Skiftning af urethrastomipose
BJMZ14	Skiftning af pose på urinafledende enterostomi
BJMZ2	Fjernelse af urostomipose
BJMZ20	Fjernelse af cystostomipose
BJMZ21	Fjernelse af nefrostomipose
BJMZ22	Fjernelse af ureterostomipose
BJMZ23	Fjernelse af urethrastomipose
BJMZ24	Fjernelse af pose på urinafledende enterostomi
BJX	Andre intervent. med rel. til urinveje og kønsorganer
BJXA	Spec.intervention med relation til urinveje og kønsorganer
BJXA0	Blæreskylning
BJXA2	Behandling af hydrocele
BJXA20	Aspiratio hydrocelis testis
BJXA21	Sclerosering hydrocelis testis
BJXA5	Pleje af kunstig vagina
BJXA6	Behandling af lidelser i tuba uterina
BJXA60	Persufflatio tubae uterinae
BJXA61	Instillatio tubae uterinae
BJXY	Procedure m.rel. til urinveje og kønsorganer ikke klass.a.st
BJXY0	Gynækologisk procedure ikke klassificeret andetsteds
BK	Graviditet og fødsel
BKH	Medikamentel behandling under graviditet, fødsel og barsel
BKHD	Behandling med uteruskontraherende middel
BKHD0	Behandling med uteruskontraherende middel efter fødsel
BKHD2	Partus provocatus medicamentalis
BKHD20	Partus provocatus medicamentalis m. prostaglandin
BKHD21	Partus provocatus medicamentalis m. oxytocin
BKHD3	Stimulatio laborum medicamentalis
BKHD30	Stimulatio laborum medicamentalis m. prostaglandin
BKHD31	Stimulatio laborum medicamentalis m. oxytocin
BKHD4	Abortus provocatus medicamentalis
BKHD40	Medicinsk induceret tidlig abort (antiprogesteron)
BKHD41	Medicinsk induceret tidlig abort (prostaglandin)
BKHD45	Medicinsk induceret sen abort (prostaglandin)
BKHD5	Medikamentel behandling efter abort, inkl. 'missed abortion'
BKHD50	Behandling med prostaglandin
BKHD51	Behandling med antiprogesteron
BKHD52	Behandling med antiprogesteron og prostaglandin
BKHD53	Behandling med oxytocin
BKHD54	Behandling med metylergometrin
BKHD8	Anden behandling med uteruskontraherende middel
BKHE	Medikamentel behandling af unormalt forløbende graviditet
BKHE0	Medicinsk behandling af ektopisk graviditet
BKHE1	Medikamentel behandling af eklampsi
BKHE2	Medikamentel behandling af praeeklampsi
BKHE3	Medikamentel behandling af hypertension i graviditeten
BKHE8	Cytostatisk behandling ved ekstrauterin graviditet
BKHG	Behandling med vehæmmende middel
BKHH	Behandling med laktationshæmmende middel
BKHI	Behandling af nyfødt med K-vitamin
BKK	Pædagogiske interv. i forb.m. graviditet,fødsel og barsel
BKKA	Pædagogiske handlinger i forbindelse med graviditet
BKKA0	Fødselsforberedelse
BKKA01	Forberedelse af fødsel med undervisning
BKKA02	Forberedelse af fødsel med instruktion
BKKA03	Forberedelse af fødsel med afspænding
BKKA04	Forberedelse af fødsel med styrketræning
BKKA05	Forberedelse af fødsel med træning i vand
BKKA2	Forberedelse i særlige forhold ved fødsel i hjemmet
BKKB	Pædagogiske interventioner i forbindelse med fødsel
BKKB0	Vejledning i lejring med henblik på barnets rotation
BKKB1	Hjælp til indtagelse af fødestillinger
BKKB10	Hjælp til indtagelse af fødestilling i fødselsøjeblikket
BKKE	Pædagogiske handlinger i forbindelse med barsel
BKKE1	Pædagogiske handlinger i forbindelse med amning
BKKE10	Vejledning i indtagelse af ammestilling
BKKE11	Vejledning om vedligeholdelse af amning
BKKE12	Vejledning i afvikling af amning
BKKE2	Stimulation mm. i forbindelse med amning
BKKE20	Stimulering af bryst
BKKE21	Stimulering af sutterefleks
BKKE22	Vejledning og instruktion i anvendelse af suttebrik
BKKE23	Facilitering af suttefunktion
BKKE4	Instruktion ved udmalkning
BKKE40	Instruktion ved manuel udmalkning
BKKE41	Instruktion ved mekanisk udmalkning
BKKE5	Instruktion i barselsgymnastik
BKKE8	Instruktion i pusling af barn
BKKG	Pædagogiske interventioner i forbindelse med abort
BKKG0	Pædagogiske interventioner i forbindelse med spontan abort
BKKG1	Pædagogiske interventioner i forbindelse med provokeret abor
BKQ	Interventioner med henblik på smertelindring ved fødsel
BKQA	Smertelindring under fødsel ved brug af hjælpemidler
BKQA0	Smertelindring under fødsel ved anbringelse i badekar
BKQA1	Smertelindring under fødsel ved anbringelse i brusebad
BKQA2	Smertelindring under fødsel ved anvendelse af varmepude
BKQA3	Smertelindring under fødsel ved anvendelse af kolde puder
BKQA4	Smertelindring under fødsel ved brug af transkutan nervestim
BKQB	Smertelindring under fødsel med brug af manuel terapi
BKQB0	Smertelindring under fødsel ved brug af massage
BKQD	Andre interventioner med smertelindring ved fødsel
BKQD0	Kontinuerlig tilstedeværelse af jordemoder
BKQD00	Kontinuerlig tilstedeværelse af jordemoder i latent fase
BKQD01	Kontinuerlig tilstedeværelse af jordemoder i aktiv fase
BKQD1	Smertelindring ved hjælp af lejringsændring
BKQD2	Smertelindring ved hjælp af fysisk bevægelse
BKQD3	Smertelindring under fødsel ved brug af vejrtrækn. og afslap
BKX	Andre interventioner i rel.til graviditet, fødsel og barsel
BKXA	Specificeret intervention i relation til graviditet, fødsel
BKXA0	Hindeløsning
BKXA1	Accouchement
BKXA2	Holde caput eller sæde oppe ved fremfald af navlesnor
BKXA3	Manuel stimulation
BKXA30	Vestimulation med zoneterapi
BKXA31	Vestimulation med akupunktur
BKXA5	Fjernelse af navleklemme
BKXA8	Early feeding (<2 timer post partum)
BKXB	Interventioner med henblik på placentafødsel
BKXB1	Assisteret fødsel af placenta
BKXB10	Assisteret fødsel af placenta ved at lægge barn til bryst
BKXB11	Assisteret fødsel af placenta ved akupunktur
BKXB12	Assisteret fødsel af placenta ved brug af syntocinon i navle
BKXB13	Assisteret fødsel af placenta ved zoneterapi
BKXC	Intervention ved blødning efter fødsel
BKXC0	Kugling af uterus
BKXC1	ompression af uterus
BKXG	Assistance ved abort
BKXG0	Assistance ved spontan abort
BKXG1	Assistance ved provokeret abort
BKZ	Særlige forhold vedrørende fødselsforløb
BKZA	Fødestilling
BKZA0	Liggende fødestilling
BKZA00	Liggende fødestilling, gynækologisk leje
BKZA01	Liggende fødestilling, sideleje
BKZA02	Liggende fødestilling, på maven over sækkestol
BKZA1	Siddende fødestilling
BKZA10	Siddende fødestilling, hugsiddende
BKZA11	Siddende fødestilling, i sækkestol
BKZA12	Siddende fødestilling, på fødestol eller -skammel
BKZA2	Stående fødestilling
BKZA20	Stående fødestilling, hængende i tov
BKZA21	Stående fødestilling, hængende i hjælper
BKZA9	Fødestilling ikke klassificeret andetsteds
BKZA90	Fødestilling på alle fire
BKZB	Fødsel i vand
BKZS	Fødestilling indtaget spontant
BL	Bevægeapparatet
BLD	Behandling med proteser, ortoser og ortopædisk fodtøj
BLDD	Behandling med overekstremitetsprotese
BLDD0	Behandling med hemiscapulær protese
BLDD00	Behandling med kosmetisk hemiscapulær protese
BLDD01	Behandling med konventionel hemiscapulær protese
BLDD02	Behandling med myo-elektrisk hemiscapulær protese
BLDD03	Behandling med kosmetisk skulderprotese
BLDD04	Behandling med speciel hemiscapulær protese
BLDD1	Behandling med skulderexartikulationsprotese
BLDD10	Behandling med kosmetisk skulderexartikulationsprotese
BLDD11	Behandling med konventionel skulderexartikulationsprotese
BLDD12	Behandling med myo-elektrisk skulderexartikulationsprotese
BLDD13	Behandling med speciel skulderexartikulationsprotese
BLDD2	Behandling med overarmsprotese
BLDD20	Behandling med kosmetisk overarmsprotese
BLDD21	Behandling med konventionel overarmsprotese
BLDD22	Behandling med myo-elektrisk overarmsprotese
BLDD23	Behandling med speciel overarmsprotese
BLDD3	Behandling med albueexartikulationsprotese
BLDD30	Behandling med kosmetisk albueexartikulationsprotese
BLDD31	Behandling med konventionel albueexartikulationsprotese
BLDD32	Behandling med myo-elektrisk albueexartikulationsprotese
BLDD33	Behandling med speciel albueexartikulationsprotese
BLDD4	Behandling med underarmsprotese
BLDD40	Behandling med kosmetisk underarmsprotese
BLDD41	Behandling med konventionel underarmsprotese
BLDD42	Behandling med myo-elektrisk underarmsprotese
BLDD43	Behandling med speciel underarmsprotese
BLDD5	Behandling med håndledsexartikulationsprotese
BLDD50	Behandling med kosmetisk håndledsexartikulationsprotese
BLDD51	Behandling med konventionel håndledsexartikulationsprotese
BLDD52	Behandling med myo-elektrisk håndledsexartikulations-protese
BLDD53	Behandling med speciel håndledsexartikulationsprotese
BLDD6	Behandling med partiel håndprotese
BLDE	Behandling med underekstremitetsprotese
BLDE0	Behandling med hemipelvectomiprotese
BLDE00	Behandling med speciel hemipelvectomiprotese
BLDE1	Behandling med hofteexartikulationsprotese
BLDE10	Behandling med speciel hofteexartikulationsprotese
BLDE2	Behandling med femurprotese
BLDE20	Behandling med speciel femurprotese
BLDE3	Behandling med knæexartikualtionsprotese
BLDE30	Behandling med speciel knæexartikualtionsprotese
BLDE4	Behandling med crusprotese
BLDE40	Behandling med PTB crusprotese
BLDE41	Behandling med speciel PTB crusprotese
BLDE42	Behandling med crusprotese med lårstykke
BLDE43	Behandling med speciel crusprotese med lårstykke
BLDE44	Behandling med Symes-protese
BLDE45	Behandling med speciel Symes-protese
BLDE46	Behandling med Pirogoff-protese
BLDE47	Behandling med speciel Pirogoff-protese
BLDE5	Behandling med kortbensprotese
BLDE50	Behandling med kortbensprotese uden knæled
BLDE51	Behandling med kortbensprotese med knæled
BLDE6	Behandling med partiel lægprotese
BLDE7	Behandling med partiel fodprotese
BLDF	Behandling med ortopædisk fodtøj
BLDF0	Behandling med ortopædisk standardfodtøj
BLDF1	Behandling med håndsyet ortopædisk fodtøj
BLDG	Behandling med ortoser
BLDG0	Behandling med overekstremitetsortose
BLDG00	Behandling med skulderortose
BLDG01	Behandling med skulder-albueortose
BLDG02	Behandling med skulder-albue-håndledortose
BLDG03	Behandling med skulder-albue-håndled-håndortose
BLDG2	Behandling med underekstremitetsortose
BLDG20	Behandling med fodortose
BLDG21	Behandling med ankel-fodortose
BLDG22	Behandling med knæortose
BLDG23	Behandling med knæ-ankel-fodortose
BLDG24	Behandling med hofteortose
BLDG25	Behandling med hofte-knæ-ankel-fodortose
BLDG5	Korsetbehandling
BLDG50	Behandling med stofkorset
BLDG51	Behandling med specialkorset
BLDG6	Behandling med halskrave
BLDG60	Behandling med blød halskrave
BLDG61	Behandling med speciel halskrave
BLDZ	Delprocedurer ved beh.med proteser, ortoser og ortopæd.fodtø
BLDZ0	Måltagning til protese, ortose og ortopædisk fodtøj
BLDZ00	Måltagning til protese
BLDZ01	Måltagning til ortose
BLDZ02	Måltagning til ortopædisk fodtøj
BLDZ1	Prøvning af protese, ortose og ortopædisk fodtøj
BLDZ10	Prøvning af protese
BLDZ11	Prøvning af ortose
BLDZ12	Prøvning af ortopædisk fodtøj
BLDZ2	Tilpasning af protese, ortose og ortopædisk fodtøj
BLDZ20	Tilpasning af protese
BLDZ21	Tilpasning af ortose
BLDZ22	Tilpasning af ortopædisk fodtøj
BLDZ3	Træning med protese, ortose og ortopædisk fodtøj
BLG	Strålebehandling med relation til bevægeapparatet
BLGA	Strålebehandling af bevægeapparatet
BLGA0	Strålebehandling af muskel
BLGA1	Strålebehandling af knogle
BLGA2	Strålebehandling af bindevæv
BLH	Medikamentel behandling af lidelser i bevægeapparatet
BLHL	Cytostatisk behandling af bevægeapparatet
BLHM	Med.systemisk beh. af lidelser i muskler, led og knogler
BLHM0	Behandling med NSAID
BLHM2	Behandling med langsomtvirkende antirheumatika
BLHM3	Behandling med lavdosis cytostatica
BLHM4	Medikamentel behandling med urinsyresænkende middel
BLHM5	Behandling med antirheumatika til udvortes brug
BLHM6	Behandling med muskelrelakserende middel
BLHN	Medikamentel lokalbeh. af lidelser i muskler, led og knogler
BLHN0	Terapeutisk steroidinjektion i led
BLHN00	Terapeutisk steroidinjektion i led på overekstremitet
BLHN01	Terapeutisk steroidinjektion i led på underekstremitet
BLHN1	Terapeutisk blokade i led og bløddele
BLHN10	Terapeutisk blokade i led og bløddele på overekstremitet
BLHN11	Terapeutisk blokade i led og bløddele på ryg og kolumna
BLHN12	Terapeutisk blokade i led og bløddele på underekstremitet
BLK	Pædagogiske interv. vedr.bevægeapparatets tilstand og funkti
BLKA	Pædagogisk intervention i forb.m.beh.af ryglidelse
BLKA0	Rådgivning om rygøvelser
BLKB	Pædagogisk handling i forb. med beh. af fodlidelse
BLKB0	Vejledning vedrørende fodtøj og -pleje
BLKC	Pædagogisk handling i forb. med brug af hjælpemiddel
BLKC0	Vejledning i anvendelse af hjælpemiddel
BLKC00	Vejledning i anvendelse af krykkestok
BLKC01	Vejledning i anvendelse af rollator og gangbuk
BLKC02	Vejledning i anvendelse af kørestol
BLKC03	Vejledning i anvendelse af tilpasset værktøj
BLKD	Pædagogisk intervention i forbindelse med bandagebehandling
BLKD0	Vejledning i pasning af gipsbandage
BLKX	Instruktion i afspænding
BLN	Interv.m. rel.til bevægeapparatets tilstand og funktion
BLNA	Biomekanisk bevægelsesterapi
BLNA0	Konditionstræning til øgning af aerobe kapacitet
BLNA1	Mobilitetstræning ved aktiv øgning af bevægelighed
BLNA2	Strækninger ved aktiv udspænding af væv
BLNA3	Styrketræning til øgning af maximale muskelkraft,
BLNA30	Koncentrisk styrketræning
BLNA31	Excentrisk styrketræning
BLNA32	Isometrisk styrketræning
BLNA4	Udholdenhedstræning til øgning af muskulær udholdenhed
BLNA40	Koncentrisk udholdenhedstræning
BLNA41	Excentrisk udholdenhedstræning
BLNA42	Isometrisk udholdenhedstræning
BLNA5	Cirkulationsbefordrende øvelser
BLNA6	Vedligeholdelsestræning ved immobilisering
BLNC	Neuromuskulær bevægelsesterapi
BLNC0	Grundmotorisk træning af basisfunktioner
BLNC00	Grundmotorisk træning med henblik på at vende sig
BLNC01	Grundmotorisk træning mhp på at rejse sig fra ligg.til sidd.
BLNC02	Grundmotorisk træning med henblik på at lægge sig ned
BLNC03	Grundmotorisk træning mhpat rejse sig fra sidd.til ståe.stil
BLNC04	Grundmotorisk træning med henblik på at sætte sig
BLNC05	Grundmotorisk træning med henblik på siddefunktionen
BLNC06	Grundmotorisk træning med henblik på standfunktionen
BLNC07	Grundmotorisk træning med henblik på gangfunktionen
BLNC08	Grundmotorisk træning med henblik på trappegangfunktionen
BLNC09	Grundmotorisk træning med henblik på brug af hjælpemiddel
BLNC1	Træning af posturalitet og balance
BLNC10	Træning af posturalitet
BLNC11	Træning af balance
BLNC2	Neurofysioterapi med henblik på facilitering
BLNC20	Facilitering ved hjælp af sansestimulering.
BLNC21	Facilitering ved hjælp af guiding
BLNC22	Facilitering ved hjælp af approximation
BLNC23	Facilitering ved hjælp af separation.
BLNC24	Facilitering ved hjælp af strækreflexudløsning
BLNC25	Facilitering ved hjælp af modstandsøvelser.
BLNC3	Neurofysioterapi med henblik på kognition
BLNC30	Neurofysioterapi med focus på neglect
BLNC31	Neurofysioterapi med focus på rum og retning
BLNC32	Neurofysioterapi med focus på koncentration
BLNC33	Neurofysioterapi med focus på initiativ
BLNC34	Neurofysioterapi med focus på perception
BLNC35	Neurofysioterapi med focus på praksi
BLNC4	Kontrakturprofylakse ved neurofysioterapi
BLNC40	Kontrakturprofylakse ved hjælp af reflekshæmning.
BLNC41	Kontrakturprofylakse ved hjælp af bandagering
BLNC42	Kontrakturprofylakse ved hjælp af mobilisering
BLNC5	Koordinationstræning
BLNC50	Koordinationstræning med henblik på præcision
BLNC51	Koordinationstræning med henblik på rytme
BLNC52	Koordinationstræning med henblik på timing
BLNC6	Neurofysioterapi med henblik på motorisk kontrol
BLNC60	Stabilitetstræning ved neurofysioterapi
BLNC61	Mobilitetstræning ved neurofysioterapi
BLNC7	Sanseintegrationstræning ved neurofysioterapi
BLNC8	Tonusregulering ved neurofysioterapi
BLNC9	Proprioceptiv træning
BLNG	Manuel terapi inkl. bløddelsbehandl.og ledmobilisering
BLNG0	Bløddelsbehandling ved manuel terapi
BLNG00	Generel cirkulationsbefordrende massage
BLNG01	Specifik cirkulationsbefordrende massage
BLNG02	Tonusregulerende massage
BLNG03	Relakserende massage
BLNG04	Massage med henblik på normalisering af væv
BLNG05	Psoasmassage
BLNG06	Massage af bækkenbundsmuskulatur
BLNG1	Ledmobilisering
BLNG10	Generel passiv ledmobilisering
BLNG11	Ledfrigøring ved specifik artikulering af et led
BLNG13	Separation af ledflader ved manuel traktion
BLNG2	Manipulation af kolumna og led
BLNG20	Manipulation af columna cervicalis
BLNG21	Manipulation af columna lumbalis
BLNG22	Artikulering af kolumna ud over normal bevægebane
BLNG3	Manuel udspændingsbehandling
BLNG30	Generel passiv vævsudspænding,
BLNG31	Specifik passiv vævsudspænding,
BLNG32	Redressering
BLNG4	Neuroreflektorisk behandling
BLNG40	Bindevævsmassage
BLNG41	Sensorisk stimulation ved manuel terapi
BLNG42	Bindevævsudspænding ved manuel terapi
BLNG43	Acupressure
BLNJ	Apparaturbehandling af lidelse i bevægeapparatet
BLNJ0	Elektroterapi
BLNJ00	Behandling med elektrisk muskelstimulation (EMS)
BLNJ01	Behandling med neuromuskulær stimulation (NMS)
BLNJ02	Behandling med funktionel el-stimulation, FES
BLNJ03	Behandling med transkutan elektrisk nervestimulation (TENS)
BLNJ04	Behandling med kombinationselektroterapi
BLNJ1	Laserbehandling
BLNJ10	Bløddelsbehandling med laser
BLNJ2	Indøvelse af muskelkontrol ved bio-feed-back
BLNJ20	Vandladningstræning med bio-feed-back
BLNJ21	Behandling af muskelspændinger med bio-feed-back
BLNJ22	Behandling af lammelse med bio-feed-back
BLNJ23	Stimul.med bio-feedback til muskelaktiv.efter immobilisation
BLNJ24	Træning med biofeed-back ved analinkontinens
BLNJ3	Mekanisk terapi
BLNJ30	Maskinel traktionsbehandling
BLNJ31	Maskinel mobiliseringsbehandling
BLNJ32	Behandling med trykbandager
BLNJ33	Ultralydbehandling
BLNJ34	Vibrationsbehandling
BLNJ35	Whirlpool-behandling
BLNJ4	Strækbehandling af kolumna
BLNJ40	Strækbehandling af columna cervicalis
BLNJ41	Strækbehandling af columna lumbalis
BLNJ5	Strækbehandling af ekstremiteter
BLNJ50	Strækbehandling af skulder og overarm
BLNJ51	Strækbehandling af albue og underarm
BLNJ52	Strækbehandling af håndled, hånd og fingre
BLNJ53	Strækbehandling af hofte og lårben
BLNJ54	Strækbehandling af knæ og underben
BLNJ55	Strækbehandling af ankelled, fod og tæer
BLNK	Termoterapi ved lidelser i bevægeapparatet
BLNK6	Termoterapi
BLNK60	Behandling med ethyl-chlorid spray
BLNK61	Behandling med ispakninger
BLNK62	Behandling med kolde pakninger
BLNK63	Behandling med varme pakninger
BLNK64	Behandling med kortbølge
BLNK65	Behandling med mikrobølge
BLNK66	Behandling med paraffinbade
BLNK67	Behandling med sandboks
BLNK68	Behandling med vekselbade
BLNN	Interventioner i forbindelse med mobilisering
BLNN0	Generel mobilisering
BLNN01	Aktiv generel mobilisering
BLNN1	Kompenserende handling mhp. forflytning
BLNN10	Kompenserende handling mhp. at komme ud af seng
BLNN11	Kompenserende handling mhp. at komme i seng
BLNN12	Kompenserende handling mhp. at komme op af stol
BLNN13	Kompenserende handling mhp. at komme i stol
BLNN2	Kompenserende støtte ved træning
BLNN20	Kompenserende støtte ved gangtræning
BLNN21	Kompenserende støtte ved trappetræning
BLNN22	Kompenserende støtte ved brug af motionscykling
BLNN23	Kompenserende støtte ved sengecykling
BLNN24	Kompenserende støtte ved deltagelse i sport
BLNN3	Komp. handling mhp. påsætning af ekstremitets-protese
BLNN30	Kompenserende handling mhp. påsætning af armprotese
BLNN31	Kompenserende handling mhp. påsætning af håndprotese
BLNN32	Kompenserende handling mhp. påsætning af femurprotese
BLNN33	Kompenserende handling mhp. påsætning af crusprotese
BLNO	Interventioner i forbindelse med lejring
BLNO0	Vending af patient i seng
BLNO1	Elevation mhp hensigtsmæssig lejring af patient
BLNO10	Elevering af hovedgærde
BLNO11	Elevering af overekstremitet
BLNO12	Elevering af underekstremitet
BLNR	Aktivitetstræning af fysisk funktion
BLNR0	Træning/stimulering af generel fysisk funktion ved aktiv.
BLNR1	Vedligeholdelse af generel fysisk funktion ved aktivitet
BLNR2	Sanseintegrationstræning ved aktivitet
BLNR3	Træning og stim.af specifik fysisk funktion ved aktivitet
BLNR30	Sansetræning ved aktivitet
BLNR31	Tonusnormalisering ved aktivitet
BLNR32	Balancetræn.v. siddende,stående og gående stilling v.aktiv.
BLNR33	Instruktion i og korrektion af bevægemønstre ved aktivitet
BLNR34	Træning af ledbevægelighed ved aktivitet
BLNR35	Arvævsbehandling ved aktivitet
BLNR36	Ergoterapeutisk kontrakturbehandling
BLNR37	Krafttræning ved aktivitet
BLNR39	Udholdenhedstræning ved aktivitet
BLNR3A	Koordinationstræning ved aktivitet
BLNR3B	Kompensation for fysisk dysfunktion ved aktivitetstræning
BLNR3C	Vedligeholdelsestræning af specifik fysisk funktion
BLP	Immobilisering og forbinding med relation til bevægeapparate
BLPA	Immobilisering og forbinding af ekstremitet
BLPA0	Skinnebehandling af ekstremitet
BLPA1	Skinnebehandling af skulderled og overarm
BLPA10	Skinnebeh. af skulderled og overarm,blød bandage inkl støtte
BLPA11	Skinnebeh. af skulderled og overarm, hård præfabr.skinne
BLPA12	Skinnebeh. af skulderled og overarm, modellerbart materiale
BLPA13	Skinnebeh. af skulderled og overarm,indiv.fremstil.bandage
BLPA2	Skinnebehandling af albue og underarm
BLPA20	Skinnebeh. af albue og underarm,blød bandage inkl støttebind
BLPA21	Skinnebeh. af albue og underarm, hård præfabr. skinne
BLPA22	Skinnebeh. af albue og underarm, modellerbart materiale
BLPA23	Skinnebeh. af albue og underarm, indiv.fremstillet bandage
BLPA3	Skinnebehandling af hånd og håndled
BLPA30	Skinnebeh. af hånd og håndled, blød bandage inck støttebind
BLPA31	Skinnebeh. af hånd og håndled, hård præfabrikeret skinne
BLPA32	Skinnebeh. af hånd og håndled, modellerbart materiale
BLPA33	Skinnebeh. af hånd og håndled, individuelt fremstil. bandage
BLPA4	Skinnebehandling af finger
BLPA40	Skinnebeh. af fingre, blød bandage inkl. støttebind
BLPA41	Skinnebeh. af fingre, hård præfabrik. skinne eller bandage
BLPA42	Skinnebeh. af fingre, modellerbart materiale inkl. gips
BLPA43	Skinnebeh. af fingre, individuelt fremstillet bandage
BLPA5	Skinnebehandling af hofte og lår
BLPA50	Skinnebeh. af hofte og lår, blød bandage inkl. støttebind
BLPA51	Skinnebehandling af hofte og lår, hård præfabrikeret skinne
BLPA52	Skinnebeh. af hofte og lår, modellarbart materiale inkl gips
BLPA53	Skinnebeh. af hofte og lår, individuelt fremstillet bandage
BLPA6	Skinnebehandling af knæ
BLPA60	Skinnebehandling af knæ, blød bandage inck støttebind
BLPA61	Skinnebehandling af knæ, hård præfabrikeret skinne
BLPA62	Skinnebehandling af knæ, modellarbart materiale inkl gips
BLPA63	Skinnebehandling af knæ, individuelt fremstillet bandage
BLPA7	Skinnebehandling af underben
BLPA70	Skinnebehandling af underben, blød bandage inck støttebind
BLPA71	Skinnebehandling af underben, hård præfabrikeret skinne
BLPA72	Skinnebeh. af underben, modellarbart materiale inkl gips
BLPA73	Skinnebeh. af underben, individuelt fremstillet bandage
BLPA8	Skinnebehandling af ankelled og fod
BLPA80	Skinnebeh. af ankelled og fod, blød bandage inck støttebind
BLPA81	Skinnebeh. af ankelled og fod, hård præfabrikeret skinne
BLPA82	Skinnebeh. af ankelled og fod, modellerbart mat. inkl gips
BLPA83	Skinnebeh. af ankelled og fod, individ. fremstillet bandage
BLPB	Bandagering af kolumna
BLPB0	Bandagering af kolumna og bækken
BLPB00	Bandag. af kolumna og bækken, blød bandage inkl støttebind
BLPB01	Bandagering af kolumna og bækken, hård præfabrikeret skinne
BLPB02	Bandagering af kolumna og bækken,modellerbart mat. inkl gips
BLPB03	Bandagering af kolumna og bækken, individ. fremst. bandage
BLPB0y	Bandagering af kolumna og bækken
BLPB1	Bandagering af columna cervicalis
BLPB10	Bandager. af columna cervicalis, bl. bandage inkl støttebind
BLPB11	Bandagering af columna cervicalis, hård præfabrikeret skinne
BLPB12	Bandager. af columna cervicalis,modellerbart mat. inkl gips
BLPB13	Bandagering af columna cervicalis, individ. fremst. bandage
BLPC	Immobilisering af overekstremitet med cirkulær bandage
BLPC0	Behandling af overekstremitet med cirkulær bandage
BLPC00	Beh. af overekstremitet med cirkulær bandage, blød
BLPC01	Beh. af overekstr. m. cirkulær bandage, hård præfabr..
BLPC02	Beh. af overekstremitet med cirkulær bandage, modellerbart
BLPC03	Beh. af overekstremitet m. cirkulær bandage, individ. frems.
BLPC1	Behandling af skulderled og overarm med cirkulær bandage
BLPC10	Beh. af skulderled og overarm m. cirkulær bandage, blød
BLPC11	Beh. af skulderled og overarm m. cirkulær bandage, hård
BLPC12	Beh. af skulderled og overarm m. cirkulær bandage,modellerb.
BLPC13	Beh. af skulderled og overarm m. cirkulær bandage, individ.
BLPC2	Behandling af albue og underarm med cirkulær bandage
BLPC20	Beh. af albue og underarm m. cirkulær bandage, blød
BLPC21	Beh. af albue og underarm m. cirkulær bandage, hård præfabr.
BLPC22	Beh. af albue og underarm m. cirkulær bandage, modellerbart
BLPC23	Beh. af albue og underarm m. cirkulær bandage,individ.frems.
BLPC3	Behandling af hånd og håndled med cirkulær bandage
BLPC30	Beh. af hånd og håndled m. cirkulær bandage, blød
BLPC31	Beh. af hånd og håndled m. cirkulær bandage, hård præfabr.
BLPC32	Beh. af hånd og håndled m. cirkulær bandage, modellerbart
BLPC33	Beh. af hånd og håndled m. cirkulær bandage, individ. frems.
BLPC4	Behandling af finger med cirkulær bandage
BLPC40	Beh. af fingre med cirkulær bandage, blød bandage
BLPC41	Beh. af fingre med cirkulær bandage, hård præfabrikeret.
BLPC42	Beh. af fingre med cirkulær bandage, modellerbart materiale
BLPC43	Beh. af fingre med cirkulær bandage, individ. fremstillet
BLPD	Immobilisering af underekstremitet med cirkulær bandage
BLPD0	Behandling af underekstremitet med cirkulær bandage
BLPD00	Beh. af underekstremitet med cirkulær bandage, blød
BLPD01	Beh. af underekstremitet m. cirkulær bandage, hård præfabr..
BLPD02	Beh. af underekstremitet med cirkulær bandage, modellerbart
BLPD03	Beh. af underekstremitet m. cirkulær bandage,individ. frems.
BLPD1	Behandling af hofte og lår med cirkulær bandage
BLPD10	Beh. af hofte og lår  med cirkulær bandage, blød
BLPD11	Beh. af hofte og lår med cirkulær bandage, hård præfabr.
BLPD12	Beh. af hofte og lår med cirkulær bandage, modellerbart
BLPD13	Beh. af hofte og lår med cirkulær bandage, individ. frems.
BLPD2	Behandling af knæ med cirkulær bandage
BLPD20	Beh. af knæ med cirkulær bandage, blød bandage inkl.støtte
BLPD21	Beh. af knæ med cirkulær bandage, hård præfabr.
BLPD22	Beh. af knæ med cirkulær bandage, modellerbart materiale
BLPD23	Beh. af knæ med cirkulær bandage, individuelt fremstillet
BLPD3	Behandling af underben med cirkulær bandage
BLPD30	Beh. af underben med cirkulær bandage, blød bandage
BLPD31	Beh. af underben med cirkulær bandage, hård præfabr.
BLPD32	Beh. af underben med cirkulær bandage, modellerbart mat.
BLPD33	Beh. af underben m. cirkulær bandage,individuelt fremstillet
BLPD4	Behandling af ankelled og fod med cirkulær bandage
BLPD40	Beh. af ankelled og fod m. cirkulær bandage, blød bandage
BLPD41	Beh. af ankelled og fod m. cirkulær bandage, hård præfabr.
BLPD42	Beh. af ankelled og fod m. cirkulær bandage, modellerbart
BLPD43	Beh. af ankelled og fod m. cirkulær bandage, individuelt
BLPY	Immobiliserende beh. og forbinding ikke klass. andetsteds
BLPY0	Behandling med stumpbandage
BLPY1	Behandling med DB-skinne
BLPY20	Anlæggelse af DB-skinne
BLPY21	Justering af DB-skinne
BLPY9	Immobilisernde behandling ikke klassificeret andetsteds
BLPY90	Behandling med mitella eller slynge
BLPY91	Behandling med tapening
BLPZ	Delprocedurer ved behandling med immobiliserende bandage
BLPZ0	Fjernelse af cirkulær gipsbandage
BLX	Andre interventioner med relation til bevægeapperatet
BLXA	Immobilisering ved sengeleje
BLXA0	Immobilisering i fladt rygleje
BLXA1	Immobilisering i rygleje med pude under hovedet
BLXB	Specificerede interventioner med relation til bevægeapperate
BLXB0	Fodterapeutisk behandling
BLXB00	Fodterapeutisk delbehandling
BLXB1	Behandling med indlæg i fodtøj
BLXB10	Indlæg i fodtøj efter funktionelt aftryk
BLXB2	Individuel aflastning af tå
BLXB20	Individuel aflastning af tå med 'Evazote'
BLXB21	Individuel aflastning af tå med silicone
BLXB22	Individuel aflastning af tå med skumgummi
BLXB3	Hælsko behandling
BM	Perifere kredsløb og lymfesystem
BMB	Anvendelse af perkutan adgang til kredsløbet
BMBA	Anvendelse af kanyle som adgang til kredsløbet
BMBA0	Anv.af kanyle som adgang til det peri.venøse kredsløb
BMBA00	Venepunktur
BMBA01	Venesektio
BMBA02	Anlæggelse af permanent venekanyle
BMBA03	Skalpvenepunktur
BMBA1	Anv. af kanyle som adgang til det arterielle kredsløb
BMBA10	Arteriepunktur
BMBD	Anvendelse af kateter som adgang til kredsløbet
BMBD0	Anv. af kateteradgang til det centrale venøse kredsløb
BMBD00	Anvendelse af centralt venekateter gennem v. jugularis
BMBD01	Anvendelse af centralt venekateter gennem vena subclavia
BMBD1	Anvendelse af kateteradgang til det arterielle kredsløb
BMBZ	Delprocedurer ved anvendelse af perkutan adgang til kredsløb
BMBZ0	Anlæggelse af kanyle i kredsløbet
BMBZ00	Anlæggelse af venekanyle
BMBZ1	Skiftning af kanyle
BMBZ10	Skiftning af venekanyle
BMBZ2	Fjernelse af kanyle
BMBZ20	Fjernelse af venekanyle
BMBZ5	Anlæggelse af kateter i kredsløbet
BMBZ50	Anlæggelse af venekateter
BMBZ50A	Perkutan nyrevenekateterisation
BMBZ50B	Perkutan binyrevenekateterisation
BMBZ50C	Perkutan levervenekateterisation
BMBZ51	Anlæggelse af centralt venekateter (CVK)
BMBZ52	Anlæggelse af arteriekateter
BMBZ6	Skiftning af kateter i kredsløbet
BMBZ60	Skiftning af venekateter
BMBZ61	Skiftning af centralt venekateter (CVK)
BMBZ62	Skiftning af arteriekateter
BMBZ7	Fjernelse af kateter i kredsløbet
BMBZ70	Fjernelse af venekateter
BMBZ71	Fjernelse af centralt venekateter (CVK)
BMBZ72	Fjernelse af arteriekateter
BMD	Anvendelse af hjælpemidler i relation til det perifere kreds
BMDD	Behandling med støttestrømper
BMDD0	Behandling med crusstøttestrømpe
BMDD1	Behandling med femurstøttestrømpe
BMDD2	Behandling med armstøttestrømpe
BMDD5	Måltagning til støttestrømpe
BMDD6	Kompenserende handling ved anvendelse af støttestrømper
BMDD60	Kompenserende handling ved påtagning af støttestrømper
BMDD61	Kompenserende handling ved aftagning af støttestrømper
BMF	Interventioner ved kredsløbssvigt mm.
BMFF	Ødembehandling
BMFF0	Ødembehandling og ødemprofylakse
BMFF00	Ødembehandling ved elevation
BMFF01	Ødembehandling ved elevation og aktivitet
BMFF02	Ødembehandling ved kompression
BMFF03	Ødembehandling ved kompression og aktivitet
BMFF04	Ødembehandling ved dynamisk arbejde og arbejdstræning
BMFF05	Ødembehandling ved manuel terapi
BMFF1	Lymfødembehandling
BMFF10	Drænage ved lymfødembehandling
BMFF11	Hudpleje ved lymfødembehandling
BMFF12	Bandagering ved lymfødembehandling
BMFF2	Venepumpeterapi
BMFL	Intervention til regulering af kropstemperatur
BMFL0	Legemsopvarmning med isolering og passiv varmekilde
BMFL00	Legemsopvarmning med dyne
BMFL01	Legemsopvarmning med varmepakning
BMFL02	Legemsopvarmning med varmedunk
BMFL03	Legemsopvarmning med varmt linned
BMFL04	Legemsopvarmning med varmesvøb
BMFL05	Legemsopvarmning med benvarmere
BMFL06	Legemsopvarmning med termolagen
BMFL07	Legemsopvarmning med termotæppe
BMFL1	Legemsopvarmning med aktiv varmekilde
BMFL10	Legemsopvarmning med el-varmetæppe
BMFL11	Legemsopvarmning med varmemadras
BMFL12	Legemsopvarmning med varmepude
BMFL13	Legemsopvarmning i varmekasse
BMFL14	Legemsopvarmning med varmelampe
BMFL15	Legemsopvarmning i kuvøse
BMFL3	Legemsafkøling ved afdækning og afkøling
BMFL30	Legemsafkøling ved fjernelse af dyne
BMFL31	Legemsafkøling med kold pakning
BMFL32	Legemsafkøling ved kold afvaskning
BMFL33	Legemsafkøling med vifte
BMFL34	Legemsafkøling ved indpakning i vådt lagen
BMFL35	Legemsafkøling med ispose
BMH	Medikamentel behandling af perifere kredsløbslidelser
BMHC	Behandling med midler med virkning på det perifere kredsløb
BMHC0	Behandling med perifere kardilaterende middel
BMHC5	Behandling med varice- og hæmoridemiddel
BMK	Pædagog.interv.med rel.til det perif.kredsløb og lymfesyst.
BML	Soignering mm.  med relation til det perifere kredsløb
BMLA	Soignering af kanyle og kateter
BMLA0	Soignering af venekanyle og -kateter
BMLA01	Børstning af centralt venøst kateter (CVK)
BMLA1	Soignering af arteriekateter
BN	Hud og underhud
BND	Trykaflastning ved brug af hjælpemidler
BNDD	Anvendelse af hjælpemiddel til trykaflastning
BNDD0	Anvendelse af trykaflastende underlag
BNDD00	Anvendelse af spencomadras til trykaflastning
BNDD01	Anvendelse af vandmadras til trykaflastning
BNDD02	Anvendelse af luftmadras til trykaflastning
BNDD03	Anvendelse af pude til trykaflastning
BNDD04	Anvendelse af viskoelastisk skum
BNDD05	Anvendelse af dynamisk vekseltryksmadras
BNG	Behandling med lys og anden ikke ioniseret stråling
BNGA	UVA-Lysbehandling
BNGA1	Lysbehandling, UV-A med psoralen
BNGA10	Lysbehandling, UV-A med psoralen, universel
BNGA11	Lysbehandling, UV-A med psoralen, hænder
BNGA12	Lysbehandling, UV-A med psoralen, fødder
BNGA13	Lysbehandling, UV-A med psoralen, hovedet
BNGA14	Lysbehandling, UVA med psoralenbad, universelt
BNGA15	Lysbehandling, UVA med psoralenbad, hænder, fødder og hoved
BNGA2	Lysbehandling, UV-B, bredspektret
BNGA20	Lysbehandling, UV-B, bredspektret, universel
BNGA21	Lysbehandling, UV-B, bredspektret, hånd
BNGA22	Lysbehandling, UV-B, bredspektret, fod
BNGA23	Lysbehandling, UV-B, bredspektret, hovedet
BNGA3	Lysbehandling, UV-B, smalspektret
BNGA30	Lysbehandling, UV-B, smalspektret, universel
BNGA31	Lysbehandling, UV-B, smalspektret, hånd
BNGA32	Lysbehandling, UV-B, smalspektret, fod
BNGA33	Lysbehandling, UV-B, smalspektret, hovedet
BNGA7	Lysbehandling med blitzlampe
BNGA70	Lysbehandling med blitzlampe, 550-950 nanometer (kar)
BNGA71	Lysbehandling med blitzlampe, 600-960 nanometer (hår)
BNGC	Fototerapi
BNGC0	Fototerapi af nyfødte
BNGC1	Fotodynamisk terapi
BNGC10	Fotodynamisk terapi med blitzlampelys
BNGD	Strålebehandling af hud og underhud
BNGD0	Dermatologisk Bucky-bestråling
BNGL	Behandling med laser
BNGL0	Dermatologisk laserbehandling
BNGL00	Dermatologisk behandling med CO2-laser
BNGL01	Dermatologisk behandling med farvestof-laser
BNGL02	Dermatologisk behandling med rubin-laser
BNH	Medikamentel behandling af hudlidelser
BNHA	Behandling med antimykotika
BNHA0	Lokalbehandling med antimykotika
BNHC	Behandling med psoriasismiddel
BNHC0	Lokalbehandling med psoriasismiddel
BNHC1	Systemisk behandling med psoriasismiddel
BNHG	Dermatologisk lokalbehandling med antibiotikum
BNHG0	Lokalbehandling med antibiotikum
BNHG00	Lokalbehandling med antibakterielt middel
BNHG01	Lokalbehandling med antiviralt middel
BNHI	Behandling med acnemiddel
BNHI0	Lokalbehandling med acnemiddel
BNHI1	Systemisk behandling med acnemiddel
BNHJ	Dermatologisk lokalbehandling med glukocortikoid
BNHJ0	Lokalbehandling med glukortikoid
BNHJ1	Lokalbehandling med glukortikoid i kombination med andet sto
BNHJ2	Lokalbeh.med glukortikoid i kombination med antiinfektivum
BNHK	Behandling med middel mod hårtab
BNHK0	Lokalbehandling med middel mod hårtab
BNHK1	Systemisk behandling med middel mod hårtab
BNHL	Cytostatisk behandling af hudtumor
BNHN	Behandling med middel mod ektoparasitter
BNHN0	Behandling med scabies middel
BNHN1	Behandling med middel mod lus
BNHY	Systemisk beh.m. dermatologisk middel ikke klass.andetsteds
BNK	Pædagogisk intervention med relation til hud og underhud
BNKA	Vejledning i hensigtsmæssig hudpleje
BNL	Skiftning og soignering med relation til hud og underhud
BNLB	Hudbehandling
BNLB0	Desinficering af hud
BNLB1	Afklipning af bullae
BNLB2	Pålægning af lærredsklude
BNLB3	Iltning af hud
BNLB4	Hud-ekspandering med ballon
BNLB5	Ekstern hud-ekspandering
BNLB6	Smøring af hud
BNLB60	Smøring af hud med blødgørende middel
BNLB61	Smøring af hud med keratolytisk middel
BNLB62	Smøring af hud med vortemiddel
BNLC	Rensning af hud
BNLC0	Hudvask
BNLC00	Skylning af hudområde
BNLC01	Steril afvaskning
BNLH	Procedurer vedrørende hår, hårbund og hårvækst
BNLH0	Medicinsk hårvask
BNLH00	Medicinsk hårvask med olie
BNLH1	Fjernelse af hårvækst
BNLH10	Rasering
BNLH11	Epilering
BNLH2	Behandling af hårbund ikke klassificeret andetsteds
BNLH3	Brug af arpkam
BNP	Forbinding og anden behandling af hudlidelser
BNPA	Sårbehandling
BNPA0	Rensning af sår
BNPA00	Afvaskning af sår
BNPA01	Skrubning af sår
BNPA02	Afklipning af nekrose
BNPA1	Forbinding af sår
BNPA10	Pålægning af forbinding til opløsning af nekrose og fibrin
BNPA11	Pålægning af sugende forbinding
BNPA12	Pålægning af forbinding med semipermeabel membran
BNPA13	Pålægning af occlusionsforbinding
BNPA14	Pålægning af omslag
BNPA15	Pålægning af steril bandage
BNPA2	Fiksering af forbinding
BNPA20	Fiksering af forbinding med hæfteplaster
BNPA21	Fiksering af forbinding med heldækkende plaster
BNPA22	Fiksering af forbinding med gazebind
BNPA23	Fiksering af forbinding med tubegaze
BNPA3	Sårbehandling med salve mm.
BNPA30	Applicering af creme på sår
BNPA31	Applicering af salve på sår
BNPA32	Pålægning af salvekompres på sår
BNPA4	Skiftning af sår
BNPA40	Skiftning af sår med steril forbinding
BNPA41	Skiftning af sår med ren forbinding
BNPA5	Pleje af brandsår og ætsninger
BNPA50	Skylning af hud og slimhinder ved brandsår
BNPA51	Skylning af hud og slimhinder ved ætsninger
BNPA8	Andre procedurer vedrørende sårbehandling
BNPA80	Suturfjernelse
BNPA81	Agraf-fjernelse
BNPA82	Lukning af sår med hæfteplaster
BNPA83	Lukning af sår med steristrips
BNPA84	Lukning af sår med lim (histoacryl)
BNPA85	Fjernelse af sårdræn
BNPA9	Sårbehandling ikke klassificeret andetsteds
BNPA90	Iltning af sår
BNPA91	Skylning af sår gennem sonde
BNPC	Dermatologisk bandagebehandling
BNPC0	Behandling med kortstrækbind
BNPC1	Behandling med langstrækbind
BNPC2	Behandling med zinklimsbandage
BNPC20	Pålægning af zinklimsbandage
BNPC21	Fjernelse af zinklimsbandage
BNPF	Interventioner ved hudtransplantation
BNPF0	Pålægning af hudtransplantat
BNPF1	Pleje af hudtransplantat
BNPF2	Pleje af huddonorsted
BNX	Andre interventioner med relation til hud og underhud
BNXA	Anden spec.intervention med relation til hud og underhud
BNXA0	Iontoforese
BNXA1	Medicinsk badebehandling
BNXA10	Medicinsk oliebad
BNXA11	Medicinsk bad med stenkulstjære
BNXA12	Medicinsk bad med bøgetræstjære
BNXA13	Medicinsk bad med kvillajatjære
BNXA14	Medicinsk bad med kaliumpermanganat (rødt bad)
BNXA15	Lokalbehandling med kaliumpermanganat (rødt bad)
BNXA8	Anden specificeret dermatologisk behandling
BNXK	Instrumentelle dermatologiske behandlinger
BNXK0	Curretage
BNXK1	Elektrodissektion
BNXY	Interv. med rel.til hud og underhud ikke klass. andetsteds
BO	Blod, blodd. organer, lymfatisk væv, væskebalance, kredsløb
BOG	Strålebehandling af bloddannende organer og lymfatisk væv
BOGA	Strålebehandling af bloddannede organer
BOGC	Strålebehandling af lymfatisk væv
BOGC1	Strålebehandling af tonsiller
BOGC2	Strålebehandling af milt
BOGC3	Strålebehandling af lymfeknuder
BOGC30	Strålebehandling af supra-/infraklavikulære lymfeknuder
BOGC31	Strålebehandling af lymfeknuder i aksil
BOGC32	Strålebehandling af lysken
BOH	Med beh m relation t blod, bloddan. organer og lymfatisk væv
BOHA	Behandling med antitrombotisk middel
BOHA0	Antikoagulationsbehandling
BOHA1	Fibrinolytisk behandling
BOHA2	Behandling med glykoprotein-receptor antagonist
BOHB	Behandling med hæmostatikum og koagulationsfaktor
BOHB0	Hæmostatisk behandling
BOHB1	Behandling med koagulationsfaktorer
BOHC	Behandling med middel mod anæmi
BOHD	Behandling med albumin og plasmasubstitutter
BOHD0	Behandling med albumin
BOHD1	Behandling med plasmasubstitutter
BOHE	Behandling med hæmatopoietisk vækstfaktor
BOHL	Cytostatisk beh af blod , bloddann. organer og lymfatisk væv
BOHL0	Cytostatisk behandling af knoglemarv
BOHL1	Cytostatisk behandling af lymfatisk væv
BOHL5	Cytostatisk behandling af metastaser i lymfeknuder
BOJ	Væsketerapi
BOJA	Behandling med elektrolytopløsninger
BOJA1	Parenteral behandling med elektrolytopløsninger
BOJA10	Behandling med natriumchloridopløsning
BOJA11	Behandling med kaliumchloridopløsning
BOJA12	Behandling med natrium-kaliumchloridopløsning
BOJA13	Behandling med natrium-kalium-calciumchloridopløsning
BOJA14	Behandling med natriumhydrogencarbonatopløsning
BOJA2	Parenteral behandling med elektrolytopløsninger og glukose m
BOJA20	Behandling med glukoseopløsning med natriumchlorid
BOJA21	Behandling med glukoseopløsning med kaliumchlorid
BOJA22	Behandling med glukoseopløsning med flere elektrolytter
BOJA23	Behandling med fruktoseopløsning med flere elektrolytter
BOJA24	Behandling med laktatopløsning med flere elektrolytter
BOK	Pædagog.interv. m. rel.til blod, væskebalance og kredsløbsfu
BOKA	Vejledning vedr. behandling af anafylaktisk chok
BOKA0	Vejl. vedr. behandling af anafylaktisk chok med tabletter
BOKA1	Vejl. vedr. behandling af anafylaktisk chok med injektion
BOQ	Behandling med blod og blodprodukter
BOQA	Behandling med blodtransfusion
BOQA0	Blodtransfusion
BOQA00	Blodtransfusion op til 1 liter
BOQA01	Blodtransfusion op til 3 liter
BOQA02	Blodtransfusion op til 5 liter
BOQA03	Blodtransfusion op til 7 liter
BOQA04	Blodtransfusion op til 9 liter
BOQA05	Blodtransfusion over 9 liter
BOQA5	Udskiftningstransfusion
BOQB	Behandling med erytrocytter
BOQB0	Behandling med erytrocytsuspension,
BOQB00	Behandling med frosset, optøet erytrocytsuspension
BOQB01	Behandling med frosset, optøet autolog erytrocytsuspension
BOQB02	Behandling med bestrålet erytrocytsuspension
BOQB03	Beh.med erytrocytsuspension fremstillet på 'Cell Saver'
BOQB04	Beh.m. erytrocytsuspension i forb. m. peroperativ hæmodiluti
BOQB1	Behandling med vasket erytrocytsuspension
BOQB10	Behandling med vasket, bestrålet erytrocytsuspension
BOQB2	Beh.med leukocytdepleteret (filtreret) erytrocytsuspension
BOQB20	Beh.m. leukocytdepleteret(filtr.),bestrålet erytrocytsusp.
BOQB3	Behandling med andre erytrocytprodukter
BOQB30	Behandling med erytrocytkoncentrat
BOQB31	Behandling med prædeponeret autolog erytrocytprodukt
BOQB32	Beh. med erytrocytprodukt til intrauterin transfusion
BOQB33	Beh. med erytrocytprodukt til neonatal udskiftningstransf.
BOQB7	Anden erytrocytbehandling
BOQB70	Erytrocytbehandling med fuldblod
BOQB71	Erytrocytbehandling med frisktappet fuldblod
BOQC	Behandling med trombocytter
BOQC0	Behandling med puljet trombocytkoncentrat
BOQC00	Behandling med bestrålet puljet trombocytkoncentrat
BOQC01	Beh.m. leukocytdepleteret(filtr.) puljet trombocytkonc.
BOQC02	Beh.m.leukocytdepleteret(filtr.),bestr.puljet trombocytkonc.
BOQC1	Behandling med trombocytkoncentrat fra enkelt donor
BOQC10	Beh.m.leukocytdepleteret(filtr.)trombocytkonc.fra enk.donor
BOQC11	Behandling med bestrålet trombocytkoncentrat fra enkelt dono
BOQC12	Beh.m.leukocytdepleteret(filtr.),bestr.trombocytkonc.fra enk
BOQC2	Beh.m.trombocytkoncentrat fremstillet på celleseparator
BOQC20	Beh.m.leukocytdepleteret(filtr.)trombocytkonc.fremst.på cell
BOQC21	Beh.m.bestrålet trombocytkoncentrat fremst.på celleseparator
BOQC22	Beh.m.leukocytdepl.(filtr.),bestr.trombocytkonc.fremst.på ce
BOQC3	Behandling med andet trombocytprodukt
BOQC30	Beh.med trombocytprodukt til intrauterin transfusion
BOQC31	Beh.m.trombocytprodukt til neonatal udskiftningstransfusion
BOQD	Behandling med leukocytter
BOQD0	Behandling med 'Buffy coat'
BOQD00	Behandling med bestrålet 'Buffy coat'
BOQD1	Beh.med granulocytkoncentrat fremstillet på celleseparator
BOQD10	Beh.m. bestrålet granulocytkoncentrat fremst.på celleseparat
BOQE	Behandling med stamcellekoncentrat
BOQE0	Behandling med stamcellekoncentrat fra knoglemarv
BOQE00	Behandling med stamcellekoncentrat fra autolog knoglemarv
BOQE01	Beh.m. oprenset stamcellekoncentrat fra autolog knoglemarv
BOQE02	Beh.m.stamcellekonc.fra aut.knoglemarv,stimul.in vitro m.væk
BOQE03	Beh.m.oprens.stamcel.konc.fra aut.knoglemarv stim.in vitro m
BOQE04	Behandling med stamcellekoncentrat fra allogen knoglemarv
BOQE05	Beh.m. oprenset stamcellekonc fra allogen knoglemarv
BOQE06	Beh.m.stamcellekonc.fra allogen knoglemarv stim.in vitro m.v
BOQE07	Beh.m.oprens.stamcellekonc.fra allog.knoglemarv stim.in vitr
BOQE1	Behandling med stamcellekoncentrat fra perifert blod
BOQE10	Behandling med stamcellekoncentrat fra autologt perifert blo
BOQE11	Beh.m.oprenset stamcellekonc.fra autologt perifert blod
BOQE12	Beh.m.stamcellekonc.fra aut.perif. blod stim.in vitro m væks
BOQE13	Beh.m.oprens.stamcellekonc.fra aut.perif.blod stim.in vitro
BOQE14	Behandling med stamcellekoncentrat fra allogent perifert blo
BOQE15	Beh.m.oprenset stamcellekonc.fra allogent perifert blod
BOQE16	Beh.m.stamcellekonc.fra allo.perif.blod stim.in vitro m væks
BOQE17	Beh.m.oprens.stamcelkonc.fra allo.perif.blod stim.in vitro v
BOQE2	Behandling med stamcellekoncentrat fra placenta og navle-sno
BOQE20	Beh.m.oprens.stamcellekonc.fra placenta og navlesnorsblod
BOQH	Behandling med plasma
BOQH0	Behandling med frisk frosset plasma
BOQH00	Behandling med bestrålet frisk frosset plasma
BOQH01	Behandling med IgA frit, frisk frosset plasma
BOQH02	Behandling med bestrålet, IgA frit, frisk frosset plasma
BOQH1	Behandling med kryopræcipitatdepleteret plasma
BOQH10	Behandling med bestrålet, kryopræcipitatdepleteret plasma
BOQH6	Plasmaudskiftning
BOQH7	Behandling med højdosis immunglobulin
BOQP	Aferesebehandling
BOQP0	Plasmaferese
BOQP00	Manuel terapeutisk plasmaferese
BOQP01	Maskinel terapeutisk plasmaferese
BOQP02	Terapeutisk, maskinel plasmaferese med immunadsorptionstekni
BOQP2	Terapeutisk trombocytaferese
BOQP3	Terapeutisk leukaferese
BOQP4	Terapeutisk aferese ikke klassificeret andetsteds
BOQP9	Behandling med fotoferese
BOU	Delprocedurer ved behandling med blod og blodprodukter
BOUA	Delprocedurer ved behandling med blod
BOUA0	Opsætning af blodtransfusion
BOUA00	Opsætning af udskiftningsblodtransfusion
BOUA1	Nedtagning efter blodtransfusion
BOUB	Delprocedurer ved behandling med blodprodukter
BOUB0	Opsætning af blodprodukter
BOUB00	Opsætning af erytrocytprodukt
BOUB01	Opsætning af trombocytprodukt
BOUB02	Opsætning af leukocytprodukt
BOUB03	Stamcelleprodukt, opsætning
BOUB1	Nedtagning efter infusion med blodprodukter
BOX	Andre interventioner med relation til blod og kredsløbsfunkt
BOXA	Speci.intervention med rel.til blod og kredsløbsfunktioner
BOXA0	Haemofiltratio
BOXA5	Bloddonortapning
BOXY	Interv. med rel. til blod og kredsløbsfunkt.ikke klass.andet
BOXY0	Regional hyperterm perfusion
BP	Medikamentel beh. af infektionssygdomme, immunisering mm.
BPH	Systemisk antibiotikabehandling af infektionssygdomme
BPHA	Behandling med penicillin
BPHA0	Behandling med benzylpenicillin
BPHA1	Behandling med syrestabilt penicillinaselabilt penicillin
BPHA2	Behandling med penicillinaseresistent penicillin
BPHA3	Behandling med penicillin med udvidet spektrum
BPHA30	Behandling med ampicilin
BPHB	Behandling med beta-laktam-antibiotikum
BPHB0	Behandling med cefalosporin
BPHB1	Behandling med monobactam
BPHB2	Behandling med carbapenem
BPHF	Beh.m.sulfonamid alene og i kombination m.a. antiinfektivum
BPHF0	Behandling med sulfonamid
BPHF1	Behandling med sulfonamid kombineret med trimethoprim
BPHG	Behandling med antimykotikum til systemisk brug
BPHG0	Systemisk behandling med antimykotikum
BPHG00	Behandling med amphotericin B
BPHG01	Behandling med fluconazol
BPHG02	Behandling med flucytosin
BPHG03	Behandling med ketoconazol
BPHH	Behandling med tuberkulostatikum
BPHH0	Behandling med ethambutol
BPHH1	Behandling med isoniazid
BPHH2	Behandling med pyrazinamid
BPHH3	Behandling med rifamycin
BPHM	Behandling med antiviralt middel
BPHM0	Behandling med middel mod herpes virus
BPHM00	Behandling med aciclovir
BPHM01	Behandling med famciclovir
BPHM02	Behandling med ganciclovir
BPHM03	Behandling med valaciclovir
BPHM9	Behandling med antiviralt middel ikke klass. andetsteds
BPHM90	Behandling med revers transskriptasehæmmer
BPHM91	Behandling med proteasehæmmer
BPHY	Behandling med antibiotika ikke klassificeret andetsteds
BPHY0	Behandling med makrolider
BPHY1	Behandling med tetracycliner
BPHY2	Behandling med chloramfenikol
BPHY3	Behandling med aminoglukosider
BPHY4	Behandling med quinoloner
BPJ	Immunmodulerende behandling
BPK	Pædagogiske interventioner ved infektionssygdomme
BPL	Desensibilisering og hyposensibilisering
BPLA	Desensibilisering
BPLB	Hyposensibilisering
BPLB0	Hyposensibilisering mod insektstik
BPLB00	Hyposensibilisering med biallergen ekstrakt
BPLB01	Hyposensibilisering med hvepseallergen ekstrakt
BPLB1	Hyposensibilisering med husstøvmideallergen ekstrakt
BPLB2	Hyposensibilisering med pollenallergen ekstrakt
BPLB3	Hyposensibilisering med dyrehårallergen ekstrakt
BPM	Behandling med immunglobulin
BPMA	Immunglobulin behandling af bakteriel sygdom
BPMA0	Behandling med immunglobulin mod bakterielle sygdomme
BPMA00	Passiv immunisering efter eksposition for stivkrampe
BPMA01	Passiv immunisering efter eksposition for difteri
BPMA02	Passiv immunisering ved botulisme
BPMB	Immunglobulin behandling af virussygdom
BPMB0	Behandling med immunglobulin mod virussygdomme
BPMB00	Passiv immunisering efter eksposition for hepatitis A
BPMB01	Passiv immunisering efter eksposition for hepatitis B
BPMB02	Passiv immunisering efter eksposition for herpes zoster
BPMB03	Passiv immunisering efter eksposition for rabies
BPMB04	Passiv immunisering efter eksposition for mæslinger
BPMB05	Passiv immunisering efter eksposition for røde hunde
BPMC	Immunglobulin behandling mod dyregifte
BPMC0	Behandling med immunglobulin mod dyregifte
BPMC00	Passiv immunisering efter hugormebid
BPMC01	Passiv immunisering efter slangebid ikke klass.andetsteds
BPMD	Blodtypeimmunisering
BPMD0	Rhesus-profylakse
BPMD1	Immunisering ved ABO-uforligelighed
BPN	Vaccinationer
BPNA	Vaccinationer mod bakterielle sygdomme
BPNA0	Vaccination mod tuberkulose (BCG)
BPNA1	Vaccination mod Hæmophilus influenzae, type B (HIB)
BPNA10	HIB, 1. børnevaccination
BPNA11	HIB, 2. børnevaccination
BPNA12	HIB, 3. børnevaccination
BPNA2	Vaccination mod kighoste
BPNA20	Kighoste, 1. børnevaccination
BPNA21	Kighoste, 2. børnevaccination
BPNA22	Kighoste, 3. børnevaccination
BPNA9	Vaccination mod andre bakterielle sygdomme
BPNA90	Vaccination mod stivkrampe
BPNA91	Vaccination mod difteri
BPNA92	Vaccination mod pneumokokker
BPNA93	Vaccination mod meningokokker, polyvalent vaccine A+C
BPNA94	Vaccination mod tyfus
BPNA95	Vaccination mod kolera
BPNB	Vaccination mod virussygdomme
BPNB0	Vaccination mod børnesygdom
BPNB00	Vaccination mod mæslinger
BPNB01	Vaccination mod fåresyge
BPNB02	Vaccination mod røde hunde
BPNB03	Vaccination mod skoldkopper
BPNB1	Vaccination mod polio
BPNB10	Vaccination mod polio (injektion)
BPNB11	Polio, 1. orale børnevaccination
BPNB12	Polio, 2. orale børnevaccination
BPNB13	Polio, 3. orale børnevaccination
BPNB2	Vaccination mod rabies
BPNB21	Vaccination mod rabies 1. gang
BPNB22	Vaccination mod rabies 2. gang
BPNB23	Vaccination mod rabies 3. gang
BPNB24	Vaccination mod rabies 4. gang
BPNB25	Vaccination mod rabies 5. gang
BPNB26	Vaccination mod rabies 6. gang
BPNB3	Vaccination mod hepatitis A
BPNB30	Vaccination mod hepatitis A, engangsvaccination
BPNB31	Vaccination mod hepatitis A, 1. gang
BPNB32	Vaccination mod hepatitis A, 2. gang
BPNB4	Vaccination mod hepatitis B
BPNB40	Vaccination mod hepatitis B, 1. gang
BPNB41	Vaccination mod hepatitis B, 2. gang
BPNB42	Vaccination mod hepatitis B, 3. gang
BPNB43	Vaccination mod hepatitis B, 4. gang
BPNB9	Vaccinationer mod andre virussygdomme
BPNB90	Vaccination mod influenza
BPNB91	Vaccination mod gul feber
BPNB92	Vaccination mod japansk encephalitis
BPNB93	Vaccination mod Früh Summer meningoencephalitis (FSME)
BPNC	Vaccination med kombinerede vacciner
BPNC0	Vaccination mod difteri, stivkrampe, polio og kighoste (DTP-
BPNC1	Vaccination mod difteri, stivkrampe og polio (Di-Te-Pol)
BPNC11	Di-Te-Pol, 1. børnevacc.
BPNC12	Di-Te-Pol, 2. børnevacc.
BPNC13	Di-Te-Pol, 3. børnevacc.
BPNC2	Vaccination mod difteri og stivkrampe
BPNC3	Vaccination mod mæslinger, fåresyge, røde hunde (MFR)
BPNC31	MFR-vaccination, når barnet er fyldt 1 år
BPNC32	MFR-vaccination, når barnet er fyldt 2 år
BPNC33	MFR-vaccination, når barnet er fyldt 3 år
BPNC34	MFR-vaccination i alderen 4 til 11 år
BPNC35	MFR-vaccination, når barnet er fyldt 12 år
BPNC36	MFR-vaccination efter det fyldte 13. år
BPNX	Revaccination
BPX	Infektionsbeskyttende isolationsbehandling
BPXA	Isolation
BPXA0	Isolationsregime
BPXA00	Isolationsregime 1: Forholdsregler mod kontaktsmitte
BPXA01	Isolationsregime 2: Forholdsregler mod enteral smitte
BPXA02	Isolationsregime 3: Forholdsregler mod smitte med børnesygdo
BPXA03	Isolationsregime 4: Forholdsregler mod luftbåren smitte
BPXA04	Isolationsregime 5: Forholdsregler ved kimfattigt regime
BR	Psyko-sociale behov og funktioner
BRA	Træning med relation til kognitive og intellektuelle funktio
BRAA	Aktivitetstræning af kognitive og intellektuelle funktioner
BRAA0	Generel kognitiv og intellekt. træning og stim.v.aktivitet
BRAA1	Specifik kognitiv og intellekt.funktionstræning v.aktivitet
BRAA10	Aktivitetstræning af vågenhed
BRAA11	Aktivitetstræning af initiativ
BRAA12	Aktivitetstræning af hukommelse
BRAA13	Aktivitetstræning af koncentration
BRAA14	Aktivitetstræning af logisk tænkning
BRAA15	Aktivitetstræning af konstruktionsevne
BRAA16	Aktivitetstræning af struktureringsevne
BRAA17	Aktivitetstræning af kropsopfattelse
BRAA18	Aktivitetstræning af sprog
BRAA19	Aktivitetstræning af skriftligt udtryk
BRAA1A	Aktivitetstræning af talbehandling
BRAA1B	Aktivitetstræning af rumopfattelse
BRAA1C	Aktivitetstræning af perception og gnose
BRAA1D	Aktivitetstræning af praksi
BRAA1E	Aktivitetstræning af egen-kontrol
BRAA2	Kompens.træning i rel.til kognitiv og intellekt.funkt. v.akt
BRAA20	Kompensationstræning i relation til vågenhed ved aktivitet
BRAA21	Kompensationstræning i relation til initiativ ved aktivitet
BRAA22	Kompensationstræning i relation til hukommelse ved aktivitet
BRAA23	Kompensationstræning i relation til koncentration ved aktivi
BRAA24	Kompens.træning i rel. til logisk tænkning ved aktivitet
BRAA25	Kompens.træning i rel. til konstruktionsevne ved aktivitet
BRAA26	Kompens.træning i rel.til struktureringsevne ved aktivitet
BRAA27	Kompens.træning i rel. til kropsopfattelse ved aktivitet
BRAA28	Kompensationstræning i relation til sprog ved aktivitet
BRAA29	Kompens.træning i rel. til skriftligt udtryk ved aktivitet
BRAA2A	Kompensationstræning i relation til talbehandling ved aktivi
BRAA2B	Kompensationstræning i relation til rumopfattelse ved aktivi
BRAA2C	Kompens.træning i rel. til perception/gnose ved aktivitet
BRAA2D	Kompensationstræning i relation til praksi ved aktivitet
BRAA2E	Kompensationstræning i relation til kontrol ved aktivitet
BRAA3	Generel vedligehold.af kognitiv og intellektuel funkt.v. akt
BRAA4	Specifik vedligehold.af kognitiv og intellektuel funkt.v. ak
BRAA5	Regulering af uhensigtsmæssig intellektuel adfærd ved aktivi
BRAA50	Aktiv.træning i rel.til at styrke erkendelse af intellek.adf
BRAA51	Aktivitetstræning i rel. til at styrke evne til at følge pla
BRAA52	Aktivitetstræning i rel. til at styrke evne til at holde aft
BRAA53	Aktiv.træning i rel. til at styrke evne til kontrol af adfær
BRB	Aktivitetstræning af psykosocial funktion
BRBA	Generel psykosocial stimulering og vedligeholdelse ved aktiv
BRBA0	Generel psykosocial stimulering ved aktivitet
BRBA1	Generel psykosocial vedligeholdelse ved aktivitet
BRBB	Specifik psykosocial funktionstræn. og vedligehold.v. aktivi
BRBB0	Specifik psykosocial funktionstræning ved aktivitet
BRBB00	Psykosocial aktivitetstræning med henblik på gruppefølelse
BRBB01	Psykosocial aktivitetstræning med henblik på almengørelse
BRBB02	Psykosocial aktiv.træning mhp at være i centrum eller perife
BRBB03	Psykosocial aktivitetstræning med henblik på social forståel
BRBB04	Psykosocial aktivitetstræning med henblik på engagement
BRBB05	Psykosocial aktivitetstræning med henblik på motivation
BRBB06	Psykosocial aktivitetstræning med henblik på tryghed
BRBB07	Psykosocial aktivitetstræning med henblik på tillid
BRBB08	Psykosocial aktivitetstræning med henblik på normer
BRBB09	Psykosocial aktivitetstræning med henblik på samarbejde
BRBB0A	Psykosocial aktivitetstræning med henblik på at udtrykke sig
BRBB0B	Psykosocial aktivitetstræning med henblik på at kontakte and
BRBB0C	Psykosocial aktivitetstræning mhp opmærksomhed på andre
BRBB0D	Psykosocial aktiv.træning mhp at sætte mål og forfølge mål
BRBB0E	Psykosocial aktiv.træning mhp at lægge planer og følge plane
BRBB0F	Psykosocial aktiv.træning mhp at holde aftaler og sende afbu
BRBB0G	Psykosocial aktivitetstræning med henblik på at vise følelse
BRBB0H	Psykosocial aktivitetstræning med henblik på at sige til og
BRBB0J	Psykosocial aktivitetstræning med henblik på at tage ansvar
BRBB0K	Psykosocial aktivitetstræning med henblik på at være i nuet
BRBB0L	Psykosocial aktiv.træning mhp at styrke selvværd
BRBB0M	Psykosocial aktiv.træning mhp at styrke realitetsopfattelse
BRBB0N	Psykosocial aktivitetstræning mhp at prøve nye roller
BRBB0P	Psykosocial aktivitetstræning mhp omidentifikation
BRBB5	Aktivitetstræning med kompensation for psykosocial funktion
BRBB50	Aktivitetstræning med korrektion af vrangforestillinger
BRBB6	Vedligehold.af specifik psykosocial funkt.v. aktivitetstræni
BRC	Træning og vedligeholdelse af psykisk funktion
BRCA	Aktivitetstræning af psykisk funktion
BRCA0	Generel psykisk stimulering og træning ved aktivitet
BRCA00	Aktivitetstræning med henblik på at styrke aktivitet
BRCA01	Aktivitetstræning med henblik på at styrke nysgerrighed
BRCA02	Aktivitetstræning med henblik på at styrke initiativ
BRCA03	Aktivitetstræning med henblik på at prøve nye udtryksformer
BRCA04	Aktivitetstræning med henblik på at udvikle nye motiver
BRCA05	Aktivitetstræning med henblik på at arbejde med udfordringer
BRCA1	Specifik psykisk funktionstræning ved aktivitet
BRCA10	Aktiv.træning mhp indsigt i og erkendelse følelser
BRCA11	Aktiv.træning mhp indsigt i og erkend. af egne handlemønstre
BRCA12	Aktiv.træning mhp erkend.af egne ressourcer og begrænsninger
BRCA13	Aktiv.træning mhp indsigt i og erkendelse af egne grænser
BRCA14	Aktiv.træning mhp indsigt i og erkendelse af årsagssammenhæn
BRCA15	Aktiv.træning mhp indsigt i og erkendelse af egne mål
BRCA16	Aktivtræning mhp at styre og administrere følelser
BRCA17	Aktivitetstræning med henblik på at styrke selvværd
BRCA18	Aktivitetstræning med henblik på at træffe beslutninger
BRCA2	Kompensationstræning ved tabt psykisk funktion
BRCA20	Aktiv.træning mhp at dæmpe og aflede hallucinationer
BRCA21	Aktivitetstræning med henblik på at dæmpe angst
BRCA3	Generel vedligeholdelse af psykisk funktion ved aktivitet
BRCA4	Vedligeholdelse af specifik psykisk funktion ved aktivitet
BRD	Psykomotorisk bevægelsesterapi
BRDA	Træning af psykomotoriske funktioner
BRDA0	Træning af kropsbevidsthed
BRDA00	Træning med focus på kropskonturer og kropsgrænser
BRDA01	Træning med focus på kropsopfattelse og body-image
BRDA02	Træning med focus på kropsoplevelse
BRDA03	Træning med focus på kropserfaring
BRDA04	Træning med focus på selvfølelse
BRDA1	Træning af kropsjeg funktionerne
BRDA10	Træning af relation til underlag og grounding
BRDA11	Træning af relation til midtlinie og lateralitet
BRDA12	Træning af relation til bevægecentrum
BRDA13	Træning af relation til centrum og periferi
BRDA14	Træning af relation til åndedræt
BRDA2	Træning af bevægelsesfærdigheder og handlemuligheder
BRDA20	Træning af omstillingsevne
BRDA21	Træning af fleksibilitet
BRDA22	Træning af kropsbeherskelse og kropskontrol
BRDA23	Træning af spændingsbalance
BRDA24	Træning af bevægestil
BRDA25	Træning af bevægeglæde
BRDA26	Træning af problemløsningsevne
BRDA27	Træning med focus på energiforbrug
BRDA28	Træning med focus på rytmefølelse
BRDA3	Træning af ekspressivitet
BRDA30	Træning af verbal ekspressivitet
BRDA31	Træning af non-verbal ekspressivitet
BRDA32	Træning af ekspressivitet i relation til energiniveau og aro
BRDA4	Træning af interaktion og kommunikation
BRDA40	Kropslig træning i 'at etablere mødet'
BRDA41	Kropslig træning af samarbejde/dialog
BRDA42	Kropslig træning af give og modtage.
BRDA43	Kropslig træning af føre og følge
BRDA44	Kropslig træning af indad- og udadrettethed
BRDA45	Stimulering af læringspotentialet
BRDC	Manuel terapi med henblik på kropsopfattelse
BRDC0	Massage med henblik på kropsopfattelse
BRDC00	Afgrænsende massage med henblik på kropsopfattelse
BRDC01	Stimulerende massage med henblik på kropsopfattelse
BRF	Interventioner i relation til mental aktivitet
BRFA	Intervention vedrørende afspænding
BRFA0	Kompenserende støtte til afspænding
BRFA00	Afspændingsøvelser med fokus på respiration
BRFA01	Indirekte respirationsøvelser
BRFA02	Direkte respirationsøvelser
BRFA03	Respirationsøvelser med henblik på smertedæmpning
BRFB	Intervention med relation til mental aktivitet
BRFB0	Intervention mhp. grænsesætning
BRFB00	Grænsesætning, påmindelse
BRFB01	Grænsesætning, forhandling
BRFB02	Grænsesætning, definering af krav
BRFB03	Grænsesætning, fastholdelse af krav
BRFB04	Grænsesætning, definering af konsekvens
BRFB05	Grænsesætning, fastholdelse af konsekvens
BRFB06	Grænsesætning, anvendelse af skærmning
BRFB07	Grænsesætning, etablering af afstand
BRFB08	Grænsesætning, etablering af nærhed
BRFB1	Intervention vedrørende valg
BRFB10	Støtte til definering af valgmuligheder
BRFB12	Støtte til beslutning om valg
BRFB2	Intervention vedrørende realitetsorientering
BRFB20	Støtte til udvikling af selvopfattelse
BRFB21	Støtte ved hjælp af containing
BRFB22	Støtte ved hjælp af validering
BRFB23	Støtte ved hjælp af konfrontation
BRFB24	Støtte ved hjælp af afledning
BRFB25	Sprogkorrigering
BRFB26	Støtte til ressourceforvaltning
BRFB5	Intervention mhp. mental træning
BRFB50	Intervention mhp. hukommelsestræning
BRFB51	Intervention mhp. taletræning
BRFB52	Musikterapi
BRFB53	Visualisering
BRFB6	Terapeutisk kommunikation
BRG	Interventioner til forbedring af social trivsel
BRGA	Interventioner vedrørende social aktivitet
BRGA0	Iværksættelse af social aktivitet
BRGA1	Deltagelse i social aktivitet
BRGA2	Deltagelse i arrangementer
BRGB	Interventioner vedrørende social kontakt
BRGB0	Kompenserende støtte vedrørende social kontakt
BRGB00	Formidling af social kontakt
BRGB01	Tilbydning af social kontakt
BRGB02	Etablering af social kontakt
BRGB03	Vedligeholdelse af social kontakt
BRGB04	Afvikling af social kontakt
BRGB05	Afslutning af social kontakt
BRH	Medikamentel behandling med relation til mentale funktioner
BRHA	Behandling med psykofarmakum
BRHA0	Behandling med antipsykotikum
BRHA1	Behandling med anxiolytikum
BRHA2	Behandling med hypnotikum
BRHA3	Behandling med sedativum
BRHD	Behandling med antidepressivum
BRHD0	Behandling med lithium
BRHE	Behandling med andre psykoaktive stoffer
BRHE0	Behandling med middel mod alkoholisme
BRHE1	Behandling med psykostimulantium og nootropikum
BRHT	Medikamentel behandling med henblik på rygeafvænning
BRHT0	Behandling med nikotinplaster
BRHT1	Behandling med nikotintyggegummi
BRK	Pædagogisk intervention vedrørende psykosociale behov
BRKA	Rådgivning vedr. udvikling og fastholdelse af socialt netvær
BRKA0	Rådgivning vedr.planlægning af dagligdagens aktiviteter
BRKA1	Rådgivning vedrørende planlægning af fritidsaktiviteter
BRKB	Rådgivning om seksualitet
BRS	Samtaleterapi
BRSA	Individuel samtaleterapi
BRSB	Samtale som del af parterapi
BRSK	Kriseterapi
BRX	Andre interventioner med relation til mentale funktioner
BRXA	Specificeret intervention med relation til mentale funktione
BRXA1	Narco-curare-elektrostimulation (NCE)
BRXA2	Fototerapi ved antidepressiv behandling
BRXB	Tvangsforanstaltninger
BRXB0	Bæltefiksering
BRXB00	Anlæggelse af bælte
BRXB01	Fjernelse af bælte
BRXB1	Tvangsmedicinering
BRXB2	Tvangstilbageholdelse
BRXT	Behandling mhp rygeafvænning ikke klassificeret andet steds
BRXT0	Rygeafvænning ved brug af akupunktur
BRXT1	Rygeafvænning ved brug af kursus
BRXY	Intervent. med rel. til mentale funktioner ikke klass. andet
BRXY0	Smertebehandling ved psykisk og psykomotorisk intervention
BRXY00	Smertebehandling med psykoterapi
BRXY01	Smertebehandling med hypnose
BRXY02	Smertebehandling med psykomotorisk behandling
BRXY03	Smertebehandling med gruppeterapi
BRXY04	Smertebehandling med samtal
BS	Kropslige behov og funktioner
BSA	Personlig hygiejne
BSAA	Badning og toilette
BSAA0	Badning
BSAA00	Sengebad
BSAA01	Brusebad
BSAA02	Karbad
BSAA1	Øvre toilette
BSAA10	Vask af ansigt og hals
BSAA11	Vask af bryst
BSAA17	Cremning af ansigt og hals
BSAA18	Cremning af bryst
BSAA2	Nedre toilette
BSAA20	Vask af genitalia
BSAA21	Sædebad
BSAA22	Skiftning af ble
BSAA23	Skiftning af hygiejnebind
BSAA24	Cremning af sædeparti
BSAA3	Kropstoilette
BSAA30	Vask af ryg
BSAA31	Vask af mave
BSAA32	Vask og rensning af navle
BSAA37	Cremning af ryg
BSAA38	Cremning af mave
BSAA4	Toilette af overekstremiteter
BSAA40	Vask af hænder
BSAA41	Vask af arme og hænder
BSAA47	Cremning af hænder
BSAA48	Cremning af arme og hænder
BSAA5	Toilette af underekstremiteter
BSAA50	Vask af fødder
BSAA51	Vask af ben og fødder
BSAA52	Fodbad
BSAA57	Cremning af fødder
BSAA58	Cremning af ben og fødder
BSAC	Kompenserende støtte ved personlig soignering
BSAC0	Soignering af ansigt
BSAC00	Barbering
BSAC01	Skægtrimning
BSAC02	Udførelse af make-up
BSAC1	Soignering af øjne
BSAC2	Soignering af næse
BSAC20	Speciel næsepleje
BSAC3	Soignering af mund
BSAC30	Mundskylning
BSAC31	Tandbørstning
BSAC32	Speciel mundpleje
BSAC33	Rensning af tandprotese
BSAC4	Soignering af ydre øre
BSAC40	Rensning af ydre øre
BSAC5	Soignering af hår
BSAC50	Frisering
BSAC51	Hårvask
BSAC6	Soignering af negle
BSD	Interventioner vedrørende vandladning og defækation
BSDA	Kompenserende støtte ved vandladning og defækation
BSDA0	Kompens.støtte v.vandladning og defækation under sengeleje
BSDA00	Bækkengivning
BSDA01	Pottegivning
BSDA02	Givning af urinkolbe
BSDA1	Kompens. støtte v. vandladning og defækation ved mobiliserin
BSDB10	Anvendelse af bækkenstol
BSDB11	Kompenserende støtte ved toiletbesøg
BSDL	Skylning af genitalia
BSS	Sikringshandlinger
BSSA	Beskyttelse mod tilskadekomst
BSSA0	Beskyttelse mod faldskade fra seng
BSSA00	Indstilling af sengehøjde
BSSA01	Anvendelse af sengeheste
BSSA02	Beklædning af sengehest
BSSA1	Beskyttelse mod faldskade ved gang
BSSA10	Anvendelse af gangstativ
BSSA11	Anvendelse af barnesele
BSSA12	Anvendelse af faldmadras
BSSA13	Anvendelse af korrekt fodtøj
BSSA2	Fiksering af ekstremitet
BSSA20	Fiksering af arm og hånd
BSSA21	Fiksering af ben og fod
BSSA3	Beskyttelse mod ild og stråler
BSSA30	Anvendelse af blyforklæde
BSSA31	Anvendelse af rygeforklæde
BSSA32	Anvendelse af brandhæmmet linned
BSSA33	Fjernelse af brandfarlige genstande
BSSA4	Beskyttelse mod farlige stoffer og genstande
BSSA40	Fjernelse af medicin
BSSA41	Fjernelse af rusmidler
BSSA42	Fjernelse af kvælningsfarlige genstande
BSSA43	Fjernelse af skarpe genstande
BSSF	Beskyttelse ved anvendelse af alarmapparatur og overvågning
BSSF0	Anvendelse af kaldeanlæg
BSSF00	Påsætning af kaldeanlæg
BSSF01	Fjernelse af kaldeanlæg
BSSF02	Anbringelse af klokke
BSSF1	Anvendelse af alarmering
BSSF2	Beskyttelse ved anvendelse af direkte overvågning mm.
BSSF20	Anvendelse af fast vagt til beskyttelse mod risiko
BSSF21	Fysisk fastholdelse af patient
BT	Daglig livsførelse
BTK	Pædagogisk intervention i forb.m. daglig livsførelse
BTKA	Pædagogisk handling i forbindelse med ADL-funktioner
BTN	Intervent.m.rel. til funkt.træning i forb.med daglig livsfør
BTNA	Funktionstræning
BTNA0	Træning i funktioner med relation til forflytninger
BTNA00	Træning i forflytning i seng
BTNA01	Træning i forflytning ind i og ud af seng
BTNA02	Træning i forflytning mellem seng og toilet/stol
BTNA03	Træning i forflytning fra stol til stol
BTNA04	Træning i forflytning op fra og ned på gulv
BTNA05	Træning i forflytning ind i og ud af køretøj
BTNA1	Funktionstræning med relation til lejring
BTNA10	Træning af lejring i reflekshæmmende siddende stilling
BTNA11	Træning af lejring i reflekshæmmende liggende stilling
BTNA12	Træning af lejring mhp trykaflastning i sidd. stilling
BTNA13	Træning af lejring mhp trykaflastning i liggende stilling
BTNA2	Funktionstræning af overekstremitet
BTNA20	Funktionstræning af skulder
BTNA21	Funktionstræning af arm
BTNA22	Funktionstræning af hånd
BTNA4	Funktionstræning i brug af hjælpemidler
BTNA40	Træning i brug af gangredskaber
BTNA41	Træning i brug af kørestol
BTNA42	Træning i brug af arbejdsstol
BTNA43	Træning i brug af el-stimulator
BTNA44	Træning i brug af specialfodtøj
BTNA45	Træning i brug af protese
BTNA46	Træning i brug af korset
BTNA47	Træning i brug af skinne og bandage
BTNA48	Træning i brug af synshjælpemiddel
BTNA49	Træning i brug af hørehjælpemiddel
BTNB	Kompens.behandling med hjælpemidler, redskaber og boligændr.
BTNB0	Kompenserende behandling med hjælpemiddel
BTNB00	Fremstilling af hjælpemiddel til kompenserende behandling
BTNB01	Tilpasning og afpr.af hjælpemiddel til kompens. behandling
BTNB1	Kompenserende behandling med tilpasset værktøj
BTNB10	Fremstilling af værktøj til kompenserende behandling
BTNB11	Tilpasning og afprøvning af værktøj til kompens.beh.
BTNB2	Kompenserende behandling ved boligændring
BTNB20	Planlægning af boligændring med bruger
BTP	Færdighedstræning i forbindelse med daglig livsførelse
BTPA	Indøvning af basale færdigheder
BTPA0	Guiding ved indøvning af basale færdigheder
BTPA00	Guiding ved indøvning af spisning
BTPA01	Guiding ved indøvning af bad og toilette
BTPA02	Guiding ved indøvning af af- og påklædning
BTPA03	Guiding ved indøvning af toiletbesøg
BTPA1	Korrektion ved indøvning af basale færdigheder
BTPA10	Korrektion ved indøvning af spisning
BTPA11	Korrektion ved indøvning af bad og toilette
BTPA12	Korrektion ved indøvning af af- og påklædning
BTPA13	Korrektion ved indøvning af toiletbesøg
BTPA2	Instruktion ved indøvning af basale færdigheder
BTPA20	Instruktion ved indøvning af spisning
BTPA21	Instruktion ved indøvning af bad og toilette
BTPA22	Instruktion ved indøvning af af- og påklædning
BTPA23	Instruktion ved indøvning af toiletbesøg
BTPA3	Motivation og stimulation ved indøvning af basale færdighede
BTPA30	Motivation og stimulation ved indøvning af spisning
BTPA31	Motivation og stimulation ved indøvning af bad og toilette
BTPA32	Motivation og stimulation ved indøvning af af- og påklædning
BTPA33	Motivation og stimulation ved indøvning af toiletbesøg
BTPA4	Strukturering ved indøvning af basale færdigheder
BTPA40	Strukturering ved indøvning af spisning
BTPA41	Strukturering ved indøvning af bad og toilette
BTPA42	Strukturering ved indøvning af af- og påklædning
BTPA43	Strukturering ved indøvning af toiletbesøg
BTPB	Kompensationstræning ved basale færdigheder
BTPB0	Kompensationstræning i brug af hjælpemiddel ved basale færdi
BTPB00	Kompensationstræning i brug af hjælpemiddel ved spisning
BTPB01	Kompens.træning i brug af hjælpemiddel ved bad og toilette
BTPB02	Kompens.træning i brug af hjælpemiddel ved af- og påklædning
BTPB03	Kompensationstræning i brug af hjælpemiddel ved toiletbesøg
BTPB04	Kompens.træning i brug af hjælpemiddel ved seksuel funktion
BTPB1	Kompens.træning af nye vaner og mønstre ved basale færdighed
BTPB10	Kompensationstræning af nye vaner og mønstre ved spisning
BTPB11	Kompens.træning af nye vaner og mønstre ved bad og toilette
BTPB12	Kompens.træning af nye vaner og mønstre ved af- og påklædnin
BTPB13	Kompens.træning af nye vaner og mønstre ved toiletbesøg
BTPB14	Kompens.træning af nye vaner og mønstre ved seksuel funktion
BTPC	Vedligeholdelse af basale færdigheder
BTPC0	Guiding ved vedligeholdelse af basale færdigheder
BTPC00	Guiding ved vedligeholdelse af færdigheder i spisning
BTPC01	Guiding ved vedligeholdelse af færdigheder i bad og toilette
BTPC02	Guiding ved vedligehold.af færdigheder i af- og påklædning
BTPC03	Guiding ved vedligeholdelse af færdigheder i toiletbesøg
BTPC1	Korrektion ved vedligeholdelse af basale færdigheder
BTPC10	Korrektion ved vedligeholdelse af færdigheder i spisning
BTPC11	Korrektion ved vedligehold.af færdigheder i bad og toilette
BTPC12	Korrektion ved vedligehold.af færdigheder i af- og påklædnin
BTPC13	Korrektion ved vedligeholdelse af færdigheder i toiletbesøg
BTPC2	Instruktion ved vedligeholdelse af basale færdigheder
BTPC20	Instruktion ved vedligeholdelse af færdigheder i spisning
BTPC21	Instruktion ved vedligehold.af færdigheder i bad og toilette
BTPC22	Instruktion ved vedligehold.af færdigheder i af- og påklædni
BTPC23	Instruktion ved vedligeholdelse af færdigheder i toiletbesøg
BTPC3	Motivation og stim.ved vedligeholdelse af basale færdigheder
BTPC30	Motivation og stim.ved vedligehold. af færdigheder i spisnin
BTPC31	Motiv.og stim.ved vedligehold.af færdigheder i bad og toilet
BTPC32	Motiv.og stim. ved vedligehold.af færdigheder i af- og påklæ
BTPC33	Motivation og stim.ved vedligehold.af færdigheder i toiletbe
BTPC4	Strukturering ved vedligeholdelse af basale færdigheder
BTPC40	Strukturering ved vedligeholdelse af færdigheder i spisning
BTPC41	Struktur.ved vedligehold.af færdigheder i bad og toilette
BTPC42	Struktur.ved vedligehold.af færdigheder i af- og påklædning
BTPC43	Strukturering ved vedligeholdelse af færdigheder i toiletbes
BTPD	Indøvning af udadvendt aktivitet
BTPD0	Indøvning af færdigheder i hjemmet
BTPD00	Indøvning af madlavning og opvask
BTPD01	Indøvning af indkøb
BTPD02	Indøvning af rengøring og oprydning
BTPD03	Indøvning af tøjvask
BTPD04	Indøvning af sengeredning
BTPD05	Indøvning af havearbejde
BTPD06	Indøvning af reparation
BTPD1	Indøvning af aktiviteter vedrørende arbejde og skole
BTPD2	Indøvning af fritidsaktiviteter
BTPD20	Indøvning af leg
BTPD21	Indøvning af hobbyaktiviteter
BTPD22	Indøvning af brug af fritidstilbud
BTPD3	Indøvning af færden
BTPD30	Indøvning af kryben og kravlen
BTPD31	Indøvning af færden til fods
BTPD32	Indøvning af færden i kørestol,
BTPD33	Indøvning af færden på cykel
BTPD34	Indøvning af færden i bil
BTPD35	Indøvning af færden i båd
BTPD36	Indøvning af færden med offentligt transportmiddel
BTPD4	Indøvning af administration af egen økonomi
BTPD40	Indøvning af brug af betalingsmidler
BTPD5	Indøvning af administration af egen medicin
BTPD6	Indøvning af kommunikation og sociale færdigheder
BTPD60	Indøvning af verbal kommunikation
BTPD61	Indøvning af skriftlig kommunikation
BTPD62	Indøvning af brug af kommunikationsudstyr
BTPD63	Indøvning af social kommunikation
BTPD7	Indøvning af brug af servicefunktioner
BTPD70	Indøvning af brug af offentlige kontorer
BTPD71	Indøvning af brug af banker
BTPD72	Indøvning af brug af forretninger
BTPD8	Indøvning af strukturering
BTPD80	Indøvning af strukturering af indhold i dagligdagen
BTPD81	Indøvning af strukturering af rytme i dagligdagen
BTPE	Kompensation for tabt funktion i forbindelse med udadvendt a
BTPE0	Kompensationstræning ved færdigheder i hjemmet
BTPE00	Kompensationstræning ved madlavning og opvask
BTPE01	Kompensationstræning ved indkøb
BTPE02	Kompensationstræning ved rengøring og oprydning
BTPE03	Kompensationstræning ved tøjvask
BTPE04	Kompensationstræning ved sengeredning
BTPE05	Kompensationstræning ved havearbejde
BTPE06	Kompensationstræning ved reparation
BTPE1	Kompensationstræning ved aktiviteter vedrørende arbejde og s
BTPE2	Kompensationstræning ved fritidsaktiviteter
BTPE20	Kompensationstræning ved leg
BTPE21	Kompensationstræning ved hobbyaktiviteter
BTPE22	Kompensationstræning ved brug af fritidstilbud
BTPE3	Kompensationstræning ved færden
BTPE30	Kompensationstræning ved kryben og kravlen
BTPE31	Kompensationstræning ved færden til fods
BTPE32	Kompensationstræning ved færden i kørestol,
BTPE33	Kompensationstræning ved færden på cykel
BTPE34	Kompensationstræning ved færden i bil
BTPE35	Kompensationstræning ved færden i båd
BTPE36	Kompensationstræning ved færden med offentligt transportmidd
BTPE4	Kompensationstræning ved administration af egen økonomi
BTPE40	Kompensationstræning ved brug af betalingsmidler
BTPE5	Kompensationstræning ved administration af egen medicin
BTPE6	Kompensationstræning ved kommunikation og sociale færdighede
BTPE60	Kompensationstræning ved verbal kommunikation
BTPE61	Kompensationstræning ved skriftlig kommunikation
BTPE62	Kompensationstræning ved brug af kommunikationsudstyr
BTPE63	Kompensationstræning ved social kommunikation
BTPE7	Kompensationstræning ved brug af servicefunktioner
BTPE70	Kompensationstræning ved brug af offentlige kontorer
BTPE71	Kompensationstræning ved brug af banker
BTPE72	Kompensationstræning ved brug af forretninger
BTPE8	Kompensationstræning ved strukturering
BTPE80	Kompens.træning ved strukturering af indhold i dagligdagen
BTPE81	Kompens.træning ved strukturering af rytme i dagligdagen
BTPF	Vedligeholdelse af udadvendt aktivitet
BTPF0	Vedligeholdelsestræning af færdigheder i hjemmet
BTPF00	Vedligeholdelsestræning i madlavning og opvask
BTPF01	Vedligeholdelsestræning i indkøb
BTPF02	Vedligeholdelsestræning i rengøring og oprydning
BTPF03	Vedligeholdelsestræning i tøjvask
BTPF04	Vedligeholdelsestræning i sengeredning
BTPF05	Vedligeholdelsestræning i havearbejde
BTPF06	Vedligeholdelsestræning i reparation
BTPF1	Vedligeholdelsestræning i aktiviteter vedr. arbejde og skole
BTPF2	Vedligeholdelsestræning i fritidsaktiviteter
BTPF20	Vedligeholdelsestræning i leg
BTPF21	Vedligeholdelsestræning i hobbyaktiviteter
BTPF22	Vedligeholdelsestræning i brug af fritidstilbud
BTPF3	Vedligeholdelsestræning i færden
BTPF30	Vedligeholdelsestræning i kryben og kravlen
BTPF31	Vedligeholdelsestræning i færden til fods
BTPF32	Vedligeholdelsestræning i færden i kørestol,
BTPF33	Vedligeholdelsestræning i færden på cykel
BTPF34	Vedligeholdelsestræning i færden i bil
BTPF35	Vedligeholdelsestræning i færden i båd
BTPF36	Vedligehold.træning i færden med offentligt transportmiddel
BTPF4	Vedligeholdelsestræning i administration af egen økonomi
BTPF40	Vedligeholdelsestræning i brug af betalingsmidler
BTPF5	Vedligeholdelsestræning i administration af egen medicin
BTPF6	Vedligeholdelsestræning i kommunikation og sociale færdighed
BTPF60	Vedligeholdelsestræning i verbal kommunikation
BTPF61	Vedligeholdelsestræning i skriftlig kommunikation
BTPF62	Vedligeholdelsestræning i brug af kommunikationsudstyr
BTPF63	Vedligeholdelsestræning i social kommunikation
BTPF7	Vedligeholdelsestræning i brug af servicefunktioner
BTPF70	Vedligeholdelsestræning i brug af offentlige kontorer
BTPF71	Vedligeholdelsestræning i brug af banker
BTPF72	Vedligeholdelsestræning i brug af forretninger
BTPF8	Vedligeholdelsestræning i strukturering
BTPF80	Vedligehold.træning i strukturering af indhold i dagligdagen
BTPF81	Vedligeholdelsestræning i strukturering af rytme i dagligdag
BTPH	Kompenserende støtte ved daglige aktiviteter
BTPH0	Kompenserende støtte ved påklædning
BTPH1	Kompenserende støtte ved afklædning
BTR	Ergonomisk afprøvning vedrørende arbejdsmiljø
BTRA	Ergonomisk optimering af arbejdsprocesser og omgivelser
BTRA0	Afprøvning af ergonomiske løsningsforslag
BTRA00	Ergonomisk afprøvning af arbejdsredskaber
BTRA01	Ergonomisk afprøvning af arbejdsteknikker
BTRA02	Ergonomisk afprøvning af arbejdsprocesser
BTRA03	Ergonomisk afprøvning af arbejdsorganisering
BTRA04	Ergonomisk afprøvning af arbejdsmiljø
BTRA1	Ergonomisk tilpasning af eksisterende arbejdsforhold
BTRA10	Ergonomisk tilpasning af arbejdsredskaber
BTRA11	Ergonomisk tilpasning af arbejdsteknikker
BTRA12	Ergonomisk tilpasning af arbejdsprocesser
BTRA13	Ergonomisk tilpasning af arbejdsorganisering
BTRA14	Ergonomisk tilpasning af arbejdsmiljø
BTRA2	Ergonomisk ændring af arbejdsforholdene
BTRA20	Ergonomisk ændring af arbejdsredskaber
BTRA21	Ergonomisk ændring af arbejdsteknikker
BTRA22	Ergonomisk ændring af arbejdsprocesser
BTRA23	Ergonomisk ændring af arbejdsorganisering
BTRA24	Ergonomisk ændring af arbejdsmiljø
BTS	Rådgivning vedrørende erhvervsaktivitet
BTSA	Rådgivning vedrørende fremtidigt erhverv
BTSB	Rådgivning vedr. individuel forebyggelse i forb.med arbejde
BTSC	Rådgivning om bevarelse af tilknytning til arbejdsmarkedet
BU	Kost og ernæring
BUA	Behandling med specifikke kostformer
BUAA	Energijusteret kost
BUAA0	Sygehuskost
BUAA00	Sygehuskost 7 MJ (lille)
BUAA01	Sygehuskost 9 MJ (mellem)
BUAA02	Sygehuskost 12 MJ (stor)
BUAA1	Kost til småtspisende
BUAA10	Kost til småtspisende 7 MJ (lille)
BUAA11	Kost til småtspisende 9 MJ (mellem)
BUAA12	Kost til småtspisende 12 MJ (stor)
BUAA2	Normalkost
BUAA20	Normalkost 7 MJ (lille)
BUAA21	Normalkost 9 MJ (mellem)
BUAA22	Normalkost 12 MJ (stor)
BUAB	Barnekost
BUAB0	Madebarnskost
BUAB1	Spædbarnskost
BUAB10	Modermælkserstatning
BUAF	Speciel kost
BUAF0	Individuelt tilpasset kost
BUAF00	Vegetarkost
BUAF01	Kost uden svinekød
BUAF02	Tygge- og synkevenlig kost
BUAF03	Kost med energi- eller proteintilskud
BUAJ	Sondeernæring
BUAJ0	Delvis sondeernæring
BUAJ1	Total sondeernæring
BUAL	Parenteral ernæring
BUAL0	Delvis parenteral ernæring
BUAL1	Total parenteral ernæring
BUB	Diæt
BUBA	Diæt ved nyresygdomme
BUBA0	CAPD-diæt
BUBA1	Diæt ved præuræmi
BUBA2	Hæmodialysediæt
BUBA8	Andre diæter ved behandling af nyresygdomme
BUBA80	Natrium- og væskereduceret diæt
BUBA81	Kaliumreduceret diæt
BUBA82	Fosfatreduceret diæt
BUBB	Diæter ved allergi og intolerance
BUBB0	Diæt uden farve- og konserveringsstoffer
BUBB1	Diæt uden pollenkrydsreagerende levnedsmidler
BUBB2	Diæt uden mælkeprodukter
BUBB3	Diæt uden æg
BUBB4	Nikkelreduceret diæt
BUBB8	Eliminationsdiæt
BUBD	Fedtstofjusteret diæt
BUBD0	Fedt- og kolesterolreduceret diæt
BUBD1	Fedtstofreduceret diæt
BUBD2	MCT diæt
BUBE	Kulhydratjusteret diæt
BUBE0	Diabetesdiæt
BUBE1	Antidumping-diæt
BUBE8	Anden kulhydratjusteret diæt
BUBE80	Glutenfri diæt
BUBE81	Laktosereduceret diæt
BUBE82	Galaktosereduceret diæt
BUBE83	Fruktosereduceret diæt
BUBF	Protein- og aminosyrejusteret diæt
BUBF0	Proteinkontrolleret diæt
BUBF1	Purinreduceret diæt
BUBY	Diæter ikke klassificeret andetsteds
BUBY0	Undersøgelsesdiæt
BUBY1	Energireduceret diæt
BUBY2	Elementardiæt
BUF	Diætvejledning
BUFA	Diætvejledning ved diabetes
BUFA0	Diætvejledning ved type 1 diabetes
BUFA00	Initial diætvejledning ved type 1 diabetes
BUFA01	Opfølgende diætvejledning ved type 1 diabetes
BUFA1	Diætvejledning ved type 2 diabetes
BUFA10	Initial diætvejledning ved type 2 diabetes
BUFA11	Opfølgende diætvejledning ved type 2 diabetes
BUFA2	Diætvejledning ved gestationel diabetes
BUFA20	Initial diætvejledning ved gestationel diabetes
BUFA21	Opfølgende diætvejledning ved gestationel diabetes
BUFA3	Diætvejledning til gravide med type 1 diabetes
BUFA30	Initial diætvejledning  til gravide med type 1 diabetes
BUFA31	Opfølgende diætvejledning  til gravide med type 1 diabetes
BUFB	Diætvejledning ved hjerte- og karsygdomme
BUFB0	Diætvejledning ved ischæmisk hjertesygdom
BUFB00	Initial diætvejledning ved ischæmisk hjertesygdom
BUFB01	Opfølgende diætvejledning ved ischæmisk hjertesygdom
BUFB1	Diætvejledning ved hyperlipidæmi
BUFB10	Initial diætvejledning ved hyperlipidæmi
BUFB11	Opfølgende diætvejledning ved hyperlipidæmi
BUFC	Diætvejledning ved nyresygdomme
BUFC0	Diætvejledning ved præuræmi
BUFC00	Initial diætvejledning ved præuræmi
BUFC01	Opfølgende diætvejledning ved præuræmi
BUFC1	Diætvejledning ved dialysebehandling
BUFC10	Initial diætvejledning ved dialyse
BUFC11	Opfølgende diætvejledning ved dialyse
BUFD	Diætvejledning ved sygdomme i mave-tarmkanalen
BUFD0	Diætvejledning ved obstipation
BUFD00	Initial diætvejledning ved obstipation
BUFD01	Opfølgende diætvejledning ved obstipation
BUFD1	Diætvejledning ved colon irritable
BUFD10	Initial diætvejledning ved colon irritable
BUFD11	Opfølgende diætvejledning ved colon irritable
BUFD2	Diætvejledning til stomipatienter
BUFD20	Initial diætvejledning til stomipatienter
BUFD21	Opfølgende diætvejledning til stomipatienter
BUFD8	Diætvejledning ved leversygdom
BUFD80	Initial diætvejledning ved leversygdom
BUFD81	Opfølgende diætvejledning ved leversygdom
BUFD9	Diætvejledning ved mave-tarmsygdom ikke klass. andetsteds
BUFD90	Initial diætvejl. ved mave-tarmsygdom ikke klass. andetsteds
BUFD91	Opfølg. diætvejl. ved mave-tarmsygdom ikke klass. andetsteds
BUFE	Diætvejledning ved allergi og intolerance
BUFE0	Diætvejl. ved allergi og intolerance over for levnedsmidler
BUFE00	Initial diætvejl. v/allergi og intolerance for levnedsmidler
BUFE00A	Diætvejl. v/allergi og intoler.for farve- og konserv.stoffer
BUFE00B	Diætvejl. v/allergi og intol.for pollenkrydsreag. levnedsmdl
BUFE00C	Diætvejl. v/allergi og intolerance over for mælkeprodukter
BUFE00D	Diætvejl. v/allergi og intolerance over for æg
BUFE01	Opfølg. diætvejl. v/allergi og intol. over for levnedsmidler
BUFE1	Eliminationsdiætvejledning
BUFE2	Vejledning af patient om astronautkost
BUFY	Diætvejledning ikke klassificeret andetsteds
BUFY0	Diætvejledning ved adipositas
BUFY00	Initial diætvejledning ved adipositas
BUFY01	Opfølgende diætvejledning ved adipositas
BUFY2	Diætvejledning ved spiseforstyrrelse
BUFY20	Initial diætvejledning ved spiseforstyrrelse
BUFY21	Opfølgende diætvejledning ved spiseforstyrrelse
BUFY3	Diætvejledning ved ernæringsterapi
BUFY30	Initial diætvejledning ved ernæringsterapi
BUFY31	Opfølgende diætvejledning ved ernæringterapi
BUFY4	Diætvejledning ved osteoporose
BUFY40	Initial diætvejledning ved osteoporose
BUFY41	Opfølgende diætvejledning ved osteoporose
BUFY9	Diætvejledning ved sygdom ikke klassificeret andetsteds
BUFY90	Initial diætvejledning ved sygdom ikke klass. andetsteds
BUFY91	Opfølgende diætvejledning ved sygdom ikke klass. andetsteds
BUH	Kostrådgivning
BUHA	Rådgivning om gode kostvaner
BUHA0	Kostrådgvining til patient med træg mave
BUK	Interventioner i forbindelse med fødeindtagelse
BUKA	Interventioner i relation til indtagelse af mad og drikke
BUKA0	Kompenserende støtte ved fremstilling af mad og drikke
BUKA01	Kompenserende støtte ved fremstilling af kold mad
BUKA02	Kompenserende støtte ved fremstilling af varm mad
BUKA03	Kompenserende støtte ved fremstilling af specialkost
BUKA04	Kompenserende støtte ved fremstilling af drikkevarer
BUKA3	Kompenserende støtte ved indtagelse af mad og drikke
BUKA30	Kompenserende støtte ved indtagelse af drikkevarer
BUKA31	Kompenserende støtte ved spisning
BUKA32	Kompenserende handling ved madning
BUKA33	Kompenserende handling ved sutteflaskegivning
BUKA34	Kompenserende handling ved udskæring af mad
BUKA5	Kompenserende støtte ved indtagelse af spisestilling
BUKA7	Servering af kost/væske
BUKA70	Servering af drikkevarer
BUKA71	Servering af mad
BUKA72	Anretning af mad
BUX	Andre interventioner i forbindelse med kost og ernæring
BUXA	Behandling med faste
BUXA0	Faste, 72 timer
BV	Kommunikation og generelle pædagogiske interventioner
BVA	Kommunikation
BVAA	Samtaler
BVAA0	Samtaler i forbindelse med indlæggelse
BVAA00	Visitationssamtale
BVAA01	Indlæggelsessamtale
BVAA02	Statussamtale
BVAA03	Evalueringssamtale
BVAA04	Udskrivningssamtale
BVAA2	Samtale ved påbegyndelse af ambulant behandling
BVAA3	Samtaler som led i behandlings- og plejeforløb
BVAA30	Samtale med patient om plejeforløb
BVAA31	Samtale med patient om operation og behandlingsforløb
BVAA32	Samtale med patient om konkret undersøgelse
BVAA33	Telefonsamtale med patient
BVAA34	Samtale med patient og pårør. som led i beh.s- og plejeforlø
BVAA35	Samtale med patient og anden behandler
BVAA36	Samtale med patient om deltagelse i kontrolleret forsøg
BVAA37	Samtale med patient om deltagelse i projekt
BVAA38	Samtale med patient om deltagelse i undervisning
BVAA4	Samtale ved påbegyndelse af hjemmepleje
BVAA5	Samtale med pårørende
BVAA50	Samtale med pårørende i telefon
BVAA6	Samtaler i forbindelse med krise
BVAA60	Samtale ved dødsfald
BVAA61	Samtale i forbindelse fritidsulykke
BVAA62	Samtale i forbindelse med incest
BVAA63	Samtale i forbindelse med vold
BVAA64	Samtale i forbindelse med voldtægt
BVAA65	Samtale efter arbejdsulykke
BVAA66	Samtale i forbindelse med arbejdsmiljøproblemer
BVAA7	Samtale om fødselsforløb
BVAA70	Samtale ved dødfødsel
BVAB	Kommunikation ved direkte kontakt
BVAB1	Personlig støtte ved direkte kontakt
BVAB10	Holde om patienten
BVAB11	Holde patienten i hånden
BVAB12	Være til stede hos patienten
BVAB13	Ledsage patienten
BVAC	Skriftlig kommunikation
BVAC0	Udlevering af skriftligt informationsmateriale
BVAC1	Brevsvar til patient
BVAC10	Brevsvar vedrørende konkret undersøgelse
BVD	Generelle pædagogiske interventioner
BVDT	Pædagogiske handlinger vedrørende rygeafvænning
BVDT0	Vejledning i brug af hjælpemidler til rygeafvænning
BVDT00	Vejledning i brug af nikotinplaster
BVDT01	Vejledning i brug af nikotintyggegummi
BVDT02	Vejledning i brug af andet hjælpemiddel
BVDY	Pædagogiske handlinger ikke klassificeret andetsteds
BVDY0	Vejledning, instruktion, undervisning og rådgivning af pt.
BVDY00	Vejledning af patient
BVDY01	Instruktion af patient i konkret fremgangsmåde
BVDY02	Oplæring af patient i manuel færdighed
BVDY03	Oplæring af patient i mestring af egen situation
BVDY04	Undervisning af patient i nødvendig viden
BVDY05	Rådgivning af patient om muligheder
BVDY06	Vejl. i forb.m. planlagt undersøgelses- og behandlingsforløb
BVDY2	Motivering af patient
BVDY3	Afledning af patient
BVDY4	Supervisering af patient
BVDY7	Hukommelsesstøtte
BVDY8	Udfyldelse af spørgeskema under vejledning
BVG	Rådgivning i forbindelse med specificeret helbredsrisiko
BVGA	Rådgivning i forbindelse med arvelig helbredsrisiko
BVGA0	Genetisk rådgivning
BVGA00	Onkogenetisk rådgivning
BW	Medikamentel behandling
BWA	Interventioner i forbindelse med medicingivning
BWAA	Medicingivning
BWAA0	Medicingivning per os
BWAA00	Medicingivning via gastrointestinal sonde
BWAA1	Medicingivning ved inhalation
BWAA2	Medicingivning via slimhinde
BWAA20	Medicingivning sublingualt
BWAA21	Medicingivning i øje
BWAA22	Medicingivning i næse
BWAA23	Medicingivning i øre
BWAA24	Medicingivning i vagina
BWAA25	Medicingivning i rectum
BWAA26	Medicingivning i stomi
BWAA27	Installatio intravesicalis
BWAA3	Medicingivning ved injektion
BWAA30	Medicingivning ved intramuskulær injektion
BWAA31	Medicingivning ved subcutan injektion
BWAA32	Medicingivning ved intracutan injektion
BWAA4	Medicingivning transcutant
BWAA40	Medicingivning ved plaster
BWAA5	Medicingivning cutant
BWAA50	Medicingivning ved påsmøring
BWAA51	Medicingivning ved lukket forbinding
BWAA52	Medicingivning ved badning
BWAA6	Medicingivning intravenøst
BWAA60	Medicingivning ved intravenøs injektion
BWAA61	Medicingivning ved intravenøs inj.gennem permanent venekatet
BWAA62	Medicingivning ved intravenøs infusion
BWAA7	Medicingivning i kropshulrum
BWAA70	Medicingivning ved intrathekal injektion
BWAA71	Medicingivning ved intraspinal injektion
BWAA72	Installatio epiduralis
BWAA73	Medicingivning ved intraperitoneal injektion
BWAA74	Medicingivning ved intraartikulær injektion
BWD	Medicinadministration
BWDA	Recepter
BWDA0	Receptudstedelse
BWDA00	Receptfornyelse
BWDA01	Telefonisk receptudstedelse
BWDB	Medicinudlevering som led i behandling
BWDB0	Udlevering af medicin
BWDB00	Udlevering af medicin til akut brug
BWDB01	Udlevering af medicin som led i spec. behandling
BWDB02	Udlevering af medicin som led i kontroll.forsøg
BWDC	Ophældning mm. af medicin
BWDC0	Doseret ophældning af medicin
BWDC00	Ophældning af medicin i engangsdosis
BWDC01	Ophældning af medicin i doseringsæske til et døgn
BWDC02	Ophældning af medicin i doseringsæske til en uge
BWDC2	Tilsætning af medicin til infusionsvæske
BWK	Pædagogiske interventioner med rel.til med.behandling
BWKA	Instruktion i medicintagning
BWZ	Administrationsmåde for lægemidler
BWZA0	Epiduralt
BWZA1	Intrathekalt
BWZA2	Perineuralt
BWZC0	Okulært
BWZC1	Intraokulært
BWZC2	Retrobulbært
BWZC3	Subkonjunktivalt
BWZD0	Nasalt
BWZD1	Aurikulært
BWZD2	Endosinusialt
BWZE0	Oralt
BWZE1	Oromukosalt
BWZE2	Dentalt
BWZE3	Gingivalt
BWZF0	Intrakardialt
BWZF1	Intrakoronart
BWZG0	Inhalation
BWZG1	Inhalation med spray
BWZG2	Endotrakeopulmonal installation
BWZG3	Intrapleuralt
BWZJ0	Peroralt
BWZJ1	Rektalt
BWZJ2	Gastrointestinal installation
BWZJ3	Intraperitonealt
BWZK0	Uretralt
BWZK1	Intravesikalt
BWZL0	Vaginalt
BWZL1	Intrauterint
BWZL2	Endocervikalt
BWZL3	Intraamnionalt
BWZL4	Intracervikalt
BWZL5	Ekstraamnionalt
BWZM0	Intramuskulært
BWZM1	Intraartikulært
BWZM2	Periartikulært
BWZM3	Intrabursalt
BWZM4	Intradiskalt
BWZM5	Intrasternalt
BWZN0	Intravenøst
BWZN1	Intraarterielt
BWZN2	Intralymfatisk
BWZQ0	Kutant
BWZQ1	Intrakutant
BWZQ2	Subkutant
BWZQ3	Transdermalt
BWZQ4	Subkutant depot
BWZX0	Intrakavernalt
BWZX1	Intralæsionalt
BZ	Tillægskoder
EVV0	normalvægtig
EVV1	undervægtig
EVV2	overvægtig
EZA	ASA funktionsniveau
EZA1	ASA funktionsniveau, ASA 1
EZA2	ASA funktionsniveau, ASA 2
EZA3	ASA funktionsniveau, ASA 3
EZA4	ASA funktionsniveau, ASA 4
EZA5	ASA funktionsniveau, ASA 5
EZA6	ASA funktionsniveau, ASA 6
EZZ	Specifikation til ventepatient
EZZ00	venstre hovedstammesygdom påvist ved KAG
EZZ01	angina pectoris-smerter umiddelb. eft. akut myokardieinfarkt
EZZ09	ventepatient
NAA	Anæstesiprocedurer
NAAA	Overvågning
NAAB	Sedation og smertelindring uden bevidsthedstab
NAAC	Generel anæstesi
NAAC0	Generel anæstesi alene ved inhalation
NAAC1	Generel i.v. anæstesi
NAAC10	Generel i.v. anæstesi uden N2O
NAAC11	Generel i.v. anæstesi suppleret med N2O
NAAC3	Generel anæstesi, kombineret i.v.- og inhalations-anæstesi
NAAC4	Generel anæstesi m. midler givet rektalt el. intramuskulært
NAAC5	Generel anæstesi kombineret med regional anæstesi
NAAD	Regional anæstesi
NAAD0	Epidural blokade
NAAD00	Cervikal blokade
NAAD01	Torakal epidural blokade
NAAD02	Lumbal epidural blokade
NAAD03	Sakral epidural blokade
NAAD1	Spinal blokade
NAAD10	Torakal spinal blokade
NAAD11	Lumbal spinal blokade
NAAD2	Kombineret epidural og spinal blokade
NAAD20	Torakal kombineret epidural og spinal blokade
NAAD21	Lumbal kombineret epidural og spinal blokade
NAAD3	Plexusblokade
NAAD30	Skalenerblokade
NAAD31	Supraklavikulær blokade
NAAD32	Aksilblokade
NAAD4	Enkelt nerve blokade
NAAD40	Femoralisblokade
NAAD41	Ischiadicusblokade
NAAD42	Obturatoriusblokade
NAAD43	Pudendusblokade
NAAD44	Medianusblokade
NAAD45	Radialisblokade
NAAD46	Ulnarisblokade
NAAD5	Andre blokader, regional anæstesi
NAAD51	Vaskulær blokade
NAAD52	Infiltrationsanæstesi
NAAD53	Paracervikal blokade
NAAD54	Fodledsblokade
NAAD55	Blokade ved herniotomia inguinalis
NAB	Proc. ved int. terapi, postopr. beh. og akutte livstr. tlst.
NABA	Postoperativ behandling
NABB	Intensiv terapi
NABS	Anæstesiologisk assistance ved akutte tilstande
NABS0	Assistance ved livstruende tilstande
NABS1	Assistance til nyfødt
NABS2	Assistance ved transport
NABS20	Assistance ved intern transport
NABS21	Assistance ved ambulancetransport
NABS3	Assistance på skadested
NABS4	Akut skadebehandling indledende/koordinerende
NAXA	Andre anæstesiologiske procedurer
NAXA99	Anæstesiprocedure uden specifikation
YAKA	Århus KH, DMARD-projekt med afprøvning af B-klass.
YAKA0	Standardvejledning for DMARD-behandling
YAKA00	Instruktion i hensigtsmæssig påklædning
YAKA1	Standardplejeplan for smerter
YAKA10	Vurdering af smerteårsager
YAKA11	Rådgivning om varme/kulde påvirkning ved smerter
YAKA12	Vejledning vedrørende aflastning ved smerter
YAKA13	Vejledning i afspændingsøvelser ved smerter
YAKA2	Standardplejeplan for træthed
YAKA20	Vurdering af træthedsårsager
YAKA21	Udfyldelse af træthedshjul
YAKA22	Rådgivning vedrørende den gode nattesøvn
YAKB	Randers, distriksterapeuter, afprøvning af B-klass.
YAKB0	Vejledning af plejepersonale
YAKB1	Vejledning af pårørende
YAKB2	Administrativt arbejde
YAKC	Roskilde/Køge, fys/ergo-afprøvning af B-klass.
YAKC0	Observation, test, vurdering, cognitiv undersøgelse
YAKC1	Undersøgelse
YAKC2	Dokumentation af intervention i relation til patient
YAKC3	Faglig forberedelse til intervention
YAKC4	Faglig opfølgning på intervention
YAKC5	Opsætning af behandlingsudstyr ved respirationslidelse
YAKC6	Tværfaglig gruppeundervisning
YAKC60	Tværfaglig gruppeundervisning ved ryglidelse
YAKC61	Tværfaglig gruppeundervisning ved gigtlidelse
YAKC62	Tværfaglig gruppeundervisning ved apoplexi
ZKC	Cancerrelateret operation
ZPP	Aflyst/afbrudt procedure
ZPP00	Ingen procedure
ZPP10	Procedure aflyst pga. patientens tilstand
ZPP10A	Proc. aflyst pga. pt. tilstand, samme dag som planlagt
ZPP10B	Proc. aflyst pga. pt. tilstand, ét døgn før fastlagt dato
ZPP10C	Proc. aflyst pga. pt. tilstand, 2-7 døgn før fastlagt dato
ZPP10D	Proc. aflyst pga. pt. tilstand, 8-31 døgn før fastl.dato
ZPP10E	Proc. aflyst pga. pt. tilstand, > 32 døgn før fastlagt dato
ZPP10F	Procedure aflyst, patienten er død
ZPP10G	Procedure aflyst pga. patientens forværrede tilstand
ZPP10H	Procedure aflyst pga. manglende indikation
ZPP12	Procedure aflyst efter patientens ønske
ZPP12A1	Proc. aflyst e. pt. ønske, samme dag som planlagt,med ny tid
ZPP12A2	Proc. aflyst e. pt. ønske, samme dag som planlagt, u. ny tid
ZPP12B1	Proc. aflyst e. pt. ønske, ét døgn før fastl.dato,med ny tid
ZPP12B2	Proc. aflyst e. pt. ønske, ét døgn før fastl.dato, u. ny tid
ZPP12C1	Proc. aflyst e. pt. ønske,2-7 døgn før fastl.dato,med ny tid
ZPP12C2	Proc. aflyst e. pt. ønske, 2-7 døgn før fastl.dato,u. ny tid
ZPP12D1	Proc.aflyst e. pt. ønske,8-31 døgn før fastl.dato,med ny tid
ZPP12D2	Proc.aflyst e. pt. ønske, 8-31 døgn før fastl.dato,u. ny tid
ZPP12E1	Proc. aflyst e. pt. ønske,>32 døgn f. fastl.dato, med ny tid
ZPP12E2	Proc. aflyst e. pt. ønske, >32 døgn f. fastl.dato, u. ny tid
ZPP13	Procedure aflyst pga. udeblivelse
ZPP13A	Procedure aflyst pga. udeblivelse, samme dag som planlagt
ZPP13B	Procedure aflyst pga. udeblivelse, ét døgn før fastlagt dato
ZPP13C	Procedure aflyst pga. udeblivelse,2-7 døgn før fastlagt dato
ZPP20	Procedure aflyst af personalemæssige årsager
ZPP20A	Proc. aflyst af personalemæss.årsager,samme dag som planlagt
ZPP20B	Proc. aflyst af personalemæss. årsager,1 døgn før fastl.dato
ZPP20C	Proc.aflyst af personalemæss.årsager,2-7 døgn før fastl.dato
ZPP20D	Proc.aflyst af personalemæs.årsager,8-31 døgn før fastl.dato
ZPP20E	Proc. aflyst af pers.mæss.årsager, >32 døgn f. fastlagt dato
ZPP21	Procedure aflyst pga. tekniske problemer
ZPP21A	Proc. aflyst pga. tekniske probl., samme dag som planlagt
ZPP21B	Proc. aflyst pga. tekniske probl., ét døgn før fastlagt dato
ZPP21C	Proc. aflyst pga. tekniske probl.,2-7 døgn før fastlagt dato
ZPP21D	Proc. aflyst pga.tekniske probl.,8-31 døgn før fastlagt dato
ZPP21E	Proc. aflyst pga. tekn. problemer,>32 døgn før fastlagt dato
ZPP22	Procedure aflyst pga. arbejdsnedlæggelse
ZPP22A	Procedure aflyst pga. arbejdsnedlæggelse, samme dag som plan
ZPP22B	Procedure aflyst pga. arbejdsnedlæggelse, ét døgn før fastla
ZPP22C	Procedure aflyst pga. arbejdsnedlæggelse, 2-7 døgn før fastl
ZPP22D	Proc. aflyst pga. arbejdsnedlæggelse, 8-31 døgn før fastlagt
ZPP22E	Proc. aflyst pga. arbejdsnedlæg., mere end 32 døgn før fastl
ZPP40	Procedure aflyst pga. akut patient
ZPP40S	Procedure aflyst pga. omprioritering af programmet
ZPP40T	Procedure aflyst, da andre procedurer trækker ud
ZPP50	Procedure aflyst pga. andre årsager, samme dag som planlagt
ZPP6	Procedure afbrudt
ZPP60	Procedure afbrudt pga. patientens peroperative tilstand
ZPP62	Procedure afbrudt pga. tekniske problemer med udstyr
ZPP64	Procedure afbrudt pga. operationstekniske årsager
ZPP65	Procedure afbrudt pga. anæstesitekniske årsager
ZPP66	Procedure afbrudt efter patientens ønske
ZPP68	Procedure afbrudt pga. andre årsager
ZPP68P	Procedure afbrudt af personalemæssige årsager
ZPP69	Procedure afbrudt pga. uspecificerede årsager
ZWCM0	Alternativ cancerbehandling
ZWCM8	Besluttet ingen behandling
ZWCM9	Patienten ønsker ikke udredning/behandling
ZZ0011	Myokardieskintigrafi, dobbeltundersøgelse
ZZ0050	PET-skanning
ZZ0060	Hjerne SPECT-undersøgelse
ZZ0080	Leukocytskintigrafi
ZZ0100	Isotopkardiografi
ZZ0200	Udskrivningskonference
ZZ0201	Samarbejde med primærsektoren
ZZ0202	Observation af patient efter undersøgelse/behandling
ZZ0203	Generel assistance  ved undersøgelse/behandling
ZZ1001	Aspiratio cytologica oesophagi endoscopica
ZZ1002	Aspiratio succus oesophagi endoscopica
ZZ1005	Investigatio dynamica oesophagi endoscopica
ZZ1006	Oesofagus-manometri
ZZ1007	pH-måling i oesofagus
ZZ1008	Oesofagus-manometri, døgnmåling
ZZ1010	Ventrikelskylning
ZZ1011	Aspiratio cytologica ventriculi endoscopica
ZZ1012	Aspiratio succus ventriculi endoscopica
ZZ1013	Investigatio dynamica ventriculi et pylori
ZZ1021	Aspiratio cytologica duodeni endoscopica
ZZ1022	Aspiratio succus duodeni endoscopica
ZZ1023	Investigatio dynamica duodeni
ZZ1049	Børstecytologisk undersøgelse i galdeveje, endoskopisk
ZZ1050	Aspiratio succus viarum biliarum endoscopica
ZZ1051	Aspiratio cytologica choledochi endoscopica
ZZ1052	Aspiratio percutanea cytologica choledochi
ZZ1053	Investigatio dynamica musculi sphinct. Oddi endoscopica
ZZ1054	Invest. dynamica m. sphinct. Oddi endoscopica, galdeveje
ZZ1055	Invest. dynamica m. sphinct. Oddi endoscopica, pankreasgang
ZZ1061	Aspiratio cytologica jejuni endoscopica
ZZ1063	Aspiratio succus jejuni endoscopica
ZZ1064	Investigatio dynamica jejuni
ZZ1067	Aspiratio cytologica ilei endoscopica
ZZ1068	Aspiratio succus ilei endoscopica
ZZ1071	Aspiratio cytologica coli endoscopica
ZZ1075	Aspiratio succus coli endoscopica
ZZ1081	Aspiratio cytologica sigmoidei endoscopica
ZZ1085	Aspiratio succus sigmoidei endoscopica
ZZ1091	Aspiratio cytologica recti endoscopica
ZZ1095	Aspiratio succus recti endoscopica
ZZ1101	Aspiratio cytologica ani endoscopica
ZZ1102	Analprofilometri
ZZ1103	Proctometri
ZZ1104	Anorektal manometri
ZZ1105	Aspiratio succus ani endoscopica
ZZ1110	Rektal eksploration
ZZ1120	Aspiratio succus pancreaticus endoscopica
ZZ1121	Aspiratio cytologica ductus pancreatici endoscopica
ZZ1122	Børstecytologisk undersøgelse i pankreasgang, endoskopisk
ZZ1230	Investigatio dynamica pelvis renis
ZZ1240	Investigatio dynamica ureteris
ZZ1250	Cystometria
ZZ1260	Investigatio statica urethrae (uretral trykprofilunders.)
ZZ1261	Investigatio dynamica urethrae
ZZ1280	Uroflowmetri
ZZ1281	Udtagelse af urin til dyrkning og resistens
ZZ1290	Investigatio mictionis (tryk, flow, EMG)
ZZ1291	Residualurin måling
ZZ1294	Blevejningstest
ZZ1310	Electromyographia sphincteris urethrae
ZZ1311	Electromyographia sphincteris ani
ZZ1370	Investigatio innervationis vesicae urinariae
ZZ1450	Hjernestammeaudiometri
ZZ1460	Elektrocochleografi
ZZ1500	Demensudredning
ZZ2001	Kontrolundersøgelse, diabetes, almindelig
ZZ2002	Kontrolundersøgelse, diabetes, udvidet
ZZ2003	Kontrolundersøgelse, diabetes, årskontrol
ZZ2100	Mantoux' prøve
ZZ2675	Gradientmåling
ZZ2687	Kardiotokografi
ZZ2690	Kardiologisk undersøgelse
ZZ2692	His-undersøgelse, lille
ZZ2693	His-undersøgelse, stor
ZZ2700	Cardiologisk elektrofysiologisk undersøgelse
ZZ3150	Arterietrykmåling
ZZ3160	Blodtryksmåling
ZZ3180	Døgn-blodtryksmåling
ZZ3190	Måling af centralt venetryk
ZZ3500	Exploratio s. examinatio in narcosi
ZZ3910	Søvnmonitorering uden CPAP-maske
ZZ3911	Søvnmonitorering med CPAP-maske
ZZ3925	EKG
ZZ3926	Øsofagus-EKG
ZZ3930	Arbejds-EKG
ZZ3931	Arbejds-EKG med iltmåling
ZZ3935	Hyperventilationstest
ZZ4020	EKG-monitorering ad modum Holter
ZZ4030	Anvendelse af kardiel eventrecorder
ZZ4050	Pacemakerkontrol
ZZ4125	Undersøgelse af næse og næsehule
ZZ4128	Bodypletysmografi
ZZ4129	Transferfaktorbestemmelse
ZZ4130	Lungefunktionsundersøgelse
ZZ4130A	Spirometri
ZZ4131	Reversibilitetsundersøgelse
ZZ4133	Metakolin-test
ZZ4136	Trykmåling af CPAP
ZZ4137	Pulsoxymetri
ZZ4138	Peak flow monitorering
ZZ4170	Bronkoalveolær lavage
ZZ4180	Cytologia portionis uteri (smear)
ZZ4190	Gynækologisk undersøgelse
ZZ4195	Gynækologisk undersøgelse i universel anæstesi
ZZ4205	Chlamydiapodning fra cervix
ZZ4206	Chlamydiapodning fra urethra
ZZ4223	Cardiotocografi, intra partum kontinuerligt
ZZ4230	Graviditetsbestemmelse, Se-HCG
ZZ4231	Se-AFP bestemmelse
ZZ4233	Cardiotocografi, ante partum
ZZ4234	Cardiotocografi, intra partum diskontinuerligt
ZZ4390	Priktest
ZZ4390A	Penicillinpriktest
ZZ4390B	Lidocainpriktest
ZZ4390C	Carbocainpriktest
ZZ4391	Udvidet priktest
ZZ4392	Provokationstest
ZZ4392A	Histaminprovokation
ZZ4392B	Penicillinprovokation
ZZ4392C	Lidocainprovokation
ZZ4392D	Carbocainprovokation
ZZ4392E	Provokation med anden medicin
ZZ4392F	Anstrengelsesprovokation
ZZ4392G	Peroral provokation med farvestoffer og konserveringsmidler
ZZ4392H	Øjenprovokation
ZZ4396	Intracutantest
ZZ4396A	Intracutantest, penicillin
ZZ4396B	Intracutantest, lidocain
ZZ4396C	Intracutantest, carbocain
ZZ4600	Cavernosometri
ZZ5000	Neuropsykologisk undersøgelse
ZZ5001	AMA-test
ZZ5002	Auditiv spændvidde
ZZ5003	Boston naming test
ZZ5004	Delvist overlappende genstande
ZZ5005	Exner
ZZ5006	Hooper
ZZ5007	Kasanin-Hanfmann
ZZ5008	Kontinuerlig subtraktion
ZZ5009	Mattis demential rating scale (MDRS)
ZZ5010	Moony-fragmenterede billeder
ZZ5011	Oplæste tekster
ZZ5012	Osterrieth
ZZ5013	Raven advanced
ZZ5014	Reading and writing skills
ZZ5015	Rey-figurer
ZZ5016	Rorscharch
ZZ5017	SDMT
ZZ5018	Selective reminding test
ZZ5019	Sentence repetition
ZZ5020	Simpel udstregningsprøve
ZZ5021	Sorting test
ZZ5022	Standard deviationer
ZZ5023	Story recall
ZZ5024	Trail Making A og B
ZZ5025	Warrington recognition tests
ZZ5026	Wais
ZZ5027	WISC
ZZ5028	Visuelle gestalter
ZZ5029	WMS Boston revision
ZZ5030	3 placerede genstande
ZZ5031	10 ordpar/10 word-pair learning test
ZZ5200	Undersøgelse af hud
ZZ5210	Undersøgelse af hud mhp. laserbehandling
ZZ7000	Synsfeltundersøgelse (perimetri)
ZZ7010	Foto af øjenbund
ZZ7015	Spaltefoto
ZZ7020	Klinisk øjenundersøgelse i universel anæstesi
ZZ7030	Elektrofysiologisk øjenundersøgelse
ZZ7045	Øjenundersøgelse, simpel inkl. med anv. af lokalanæst/farve
ZZ7049	Kontrolundersøgelse, oftalmologisk
ZZ7050	Øjenundersøgelse, anden
ZZ7090	Undersøgelse af ydre øre og trommehinde
ZZ9010	Medikamentel behandling, kontrol af
ZZ9050	Test med farmaka
ZZ9950	Forundersøgelse
ZZ9951	Førstegangsundersøgelse
ZZ9990	Undersøgelse uden specifikation
ZZV000	Vurdering af prøvesvar
