AAAA00	EEG overvåking med ekstrakranielle elektroder
AAAA05	EEG overvåking med intrakranielle elektroder
AAAA10	Corticografi
AAAA20	Peroperativ overvåking med fremkalte responser
AADE00	Cerebral ultralyd avbildning, ev. dupleks, uten kontrast
AADE02	Cerebral ultralyd avbildning, ev. dupleks, med kontrast
AAFE00	Standard elektroencefalografi (EEG)
AAFE05	Søvndeprivert EEG
AAFE10	EEG langtidsregistrering
AAFE15	EEG med sfenoidal- eller epifarynkselektroder
AAFE20	EEG med reaksjonstidsmåling
AAFE22	EEG med amylaltest
AAFE25	Kvantitativ EEG analyse
AAFE30	Cerebral funksjonsmonitorering ved EEG
AAFE60	Peroperativ målsøking ved dyp hjernestimulering
AAFE80	Visuelt fremkalt potensial (VEP)
AAFE82	Elektroretinografi (ERG)
AAFE85	Elektrisk respons audiometri
AAFE87	Transtympanal hjernestammeaudiometri
AAFE89	Sensorisk fremkalt potensial (SEP) IKA
AAFF00	Transkraniell Doppler (TCD), enkel
AAFF05	Transkraniell Doppler  (TCD), fullstendig
AAFF10	TCD med intravenøs kontrast
AAFM00	Kontinuerlig måling av intracerebralt trykk
AAFX00	Polygrafisk monitorering av respiratoriske parametre (polygrafi)
AAFX05	Polysomnografi (PSG) uten respiratoriske parametre
AAFX10	Polysomnografi (PSG) med respiratoriske parametre
AAFX20	Multippel søvnlatenstest med minst åtte parametere under søvn
AAGB00	Transkraniell magnetisk stimulering (TMS)
AAGB10	Funksjonell stimulering med intrakranielle EEG elektroder
AAGT00	Innstilling av elektrisk stimulator med intracerebrale elektroder
AAGT05	Innstilling av elektrisk stimulator for dyp hjernestimulering
AAGT10	Innstilling av hydrocefalusshunt
ABEX00	Endoskopisk intraspinal undersøkelse
ABFX00	Lumbalpunksjon med infusjonstest
ABFX05	Spinal tappetest
ABFX10	Bulbocavernøs reflekstest
ABGB00	Magnetisk stimulering av nerverøtter eller pleksus
ABGC10	Innlegging av epiduralkateter
ABGC11	Innlegging av epiduralkateter med subkutan injeksjonsport
ABGT00	Innstilling/kontroll av elektrisk stimulator, ryggmarg
ABGT05	Kontroll/omlegging ved epidural eller intradural smertebehandling
ABGX00	Epidural blodlapp
ACFE00	Sensorisk nevrografi med nålelektrode
ACFE05	Sensorisk nevrografi med overflateelektrode
ACFE10	Motorisk nevrografi med nålelektrode
ACFE15	Motorisk nevrografi med overflateelektrode
ACFE20	Motorisk inchingundersøkelse
ACFE25	Nevrografi med repetitiv nervestimulering
ACFE30	Blinkrefleks nevrografi
ACFE39	Motorisk og sensorisk elektronevrografi IKA
ACFE99	Elektrofysiologisk registrerte reflekser IKA
ACFX05	Termotest
ACFX10	H-refleks
ACFX15	Vibrametri
ACGB59	Transkutan nervestimulering INA
ACGB69	Direkte nervestimulering INA
ACGB89	Intrakutan nervestimulering INA
ACGX90	Nevrolyse ved injeksjon av nevrotoksisk substans
ACGX99	Nevrolyse IKA
ADFX00	P300 eller tilsvarende kognitive responser
ADFX05	Sympatisk hudresponstest
ADFX10	Parasympatisk R-R respons
ADFX15	Posturaltest
ADFX20	Valsalvatest
ADGB00	Stimulering av vagusnerven
ADGT00	Innstilling av elektrisk stimulator for vagusstimulering
AXDP00	Videofrenzelundersøkelse
AXFE00	Elektromyografi (EMG), visuell vurdering
AXFE02	Elektromyografi  (EMG), kvantitativ
AXFE05	Single fibre elektromyografi  (SFEMG)
AXFE10	Makro elektromyografi (EMG)
AXFE15	Elektromyografiledet injeksjon
AXFE25	Elektronystagmografi med eller uten kalorisk prøve
AXFX00	Diagnostisk legemiddeltest
AXFX09	Kvantitative sensoriske tester IKA
BCFX00	Funksjonstest ved synacthenstimulering
BCFX05	Funksjonstest ved metopironstimulering
BCFX10	Funksjonstest ved insulinstimulering
BCFX15	Funksjonstest ved suppresjon med dexamethason, kortvarig
BCFX20	Funksjonstest ved suppresjon med dexamethason, langvarig
BCFX25	Funksjonstest med saltvannsbelastning
BCGC00	Binyre venekateterisering
BEFX30	Tørsteprøve med osmolaritetsmåling i serum og urin
BEFX35	Tørsteprøve med utvidet urinanalyse
BEFX40	Funksjonstest ved GnRH-stimulering
BEFX45	Funksjonstest ved GHRH-stimulering
BEFX50	Funksjonstest med argininstimulering
BEFX55	Funksjonstest med TRH-stimulering
BEFX60	Funksjonstest ved CRH-stimulering
BEFX65	Funksjonstest ved stimulering med kombinasjoner av aktiveringshormoner
BEFX70	Funksjonstest ved suppresjon av veksthormon med glukose
BEFX75	Funksjonstest ved suppresjon av veksthormon med oktreotid eller bromocriptin
BGFX00	Funksjonstest med glucagonstimulering av C-peptid
BGFX05	Registrering av blodsukker med subkutan sensor
BGFX10	Fasteprøve over lang tid med måling av glukose m.m.
BGFX15	Funksjonstest med peroral glukosebelastning
BGFX20	Funksjonstest med laktosebelastning
BXFX10	Tyreoideafunksjonstest ved pentagastrinstimulering
BXFX15	Funksjonstest ved kalsiuminfusjon
BXFX89	Spesifisert hormonprofil IKA
CCFX00	Diagnostisk irrigasjon av tåreveiene
CCFX05	Undersøkelse av tåreproduksjon
CDDP20	Fotoangiografi av øye
CDFM05	Trykkurve, øye, langtidsregistrering
CDFX10	Akselengdemåling av øyeglobus
CEFE00	Elektromyografi (EMG) av øyemuskler
CEFX00	Utredning av skjeling
CGFT00	Ultralyd biomikroskopi av hornhinne
CGFX05	Keratometri
CGFX06	Utvidet keratometri med C-scan
CGFX15	Måling av korneatykkelse (pachymetri)
CGGX00	Corneaskylling med skyllelinse
CHDP00	Fotografisk registrering av iris med intravenøst kontrastmiddel
CHFX05	Provokasjonstest ved trangvinkelglaukom
CKDP10	Fundusfotografi
CKFF00	Måling av blodstrøm i øyets bakre segment
CKFX00	Retinaundersøkelse av premature/nyfødte
CKFX15	Lasermåling av papilleekskavasjonen
CKFX20	Måling av tykkelsen på nervefiberlaget i fundus
CKGX00	Fotodynamisk behandling ved makuladegenerasjon
CXDE00	Ultralydundersøkelse av øye
CXDP00	Fotografisk opptak av øyets ytre deler
CXFX00	Perimetri
CXFX05	Kontrastsynundersøkelse
CXFX12	Utvidet fargesanstest med anomaloskop
CXFX15	Mørkesynsundersøkelse
CXFX20	Måling av akkomodasjonsbredde
CXFX25	Nevrooftalmologisk undersøkelse
CXGC00	Tilpasning av synshjelpemiddel
CXGC05	Tilpasning av øyeprotese
DBFX00	Tubosonometri
DBGX20	Avstøping av øregang
DFFE86	Elektrocochleografi
DFFX00	Promontorialtest ved utredning for cochleaimplantat
DFFX05	Stabilometri
DFFX10	Otonevrologisk utredning av svimmelhet
DFFX87	Registrering av otoakustiske emisjoner
DFGT00	Utprøving av hørselhjelpemiddel ved øresus
DFGX05	Behandlingsmanøvre ved vertigo
DFGX10	Medikamentell destruksjon av labyrinten
DFGX15	"Samtaleterapi ved øresus, ""Tinnitus Retraining Therapy"""
DFGX25	Analyse av øresus med frekvensbestemmelse m.m.
DHFM00	Rhinomanometri
DHFX00	Nasal børsteprøve ved mistenkt primær ciliedyskinesi
DHFX05	Akustisk rhinometri
DHGX00	Fjerning av fremmedlegeme i nese
DQDP00	Høyhastighetsfilming av stemmebånd
DQDP05	Stroboskopi av stemmebånd
DQDP10	Videostroboskopi av stemmebånd
DXDE00	Ultralydundersøkelse av bihuler
DXDE10	Ultralydundersøkelse av strupe og hals m.m.
DXFX10	Toneaudiogram med luft- og/eller beinledning
DXFX11	Tympanometri
DXFX12	Akustisk impedansmåling, utvidet
DXFX15	Taleaudiogram
DXFX17	Rentoneaudiometri, spesialprøver
DXFX18	Taleaudiometri i fritt felt
DXFX20	Barneaudiologisk test med uformelle prøver
DXFX25	Barneaudiologisk test med observasjons- og lekeaudiometri
DXGT00	Høreapparat utprøving
DXGX20	Rengjøring av radikaloperert øre
DXGX25	Rengjøring av annen operasjonskavitet (bihuler e.a.)
EBGC00	Tilpasning av bittskinne
EHDA00	Videofluoroskopi av velopharynxfunksjon under tale
EHET00	Fiberskopisk undersøkelse av velopharynxfunksjon ved svelging
EJFX00	Utredning av lukt og smak
ELFC00	Salivvolumsmåling
EXDA00	Fluoroskopi av orofaryngeal svelging
EXFX00	Undersøkelse av svelge-, spise- og drikkefunksjon
FAFM00	Invasiv måling av sentralt venetrykk
FBGC00	Innlegging eller bytte av kateter i lungearterie
FDGM00	Medikamentell lukning av ductus arteriosus
FDGM05	Medikamentell åpning av ductus arteriosus
FHGX00	Perkutan ablasjon av ventrikkelseptum ved etanolinjeksjon i koronarkar
FJDB02	Angiokardiografi ved høyre hjertekateterisering med én kontrastinjeksjon
FJDB03	Angiokardiografi ved høyre hjertekateterisering med mer enn én kontrastinjeksjon
FJFX01	Måling av trykk og flow i lille kretsløp ved hjertekateterisering
FNDE00	Perkutan transluminal intrakoronar ultralydundersøkelse uten Doppler
FNDE05	Perkutan transluminal intrakoronar ultralydundersøkelse med Doppler
FNFM00	Intrakoronar trykkregistrering med medikamentinjeksjon
FNOB00	Perkutan intrakoronar brakyterapi
FPFE13	Vektor-EKG
FPFE14	Senpotensial-EKG
FPFE15	Holter-EKG med 24 timers arytmianalyse
FPFE16	Holter-EKG med ST-analyse
FPFE17	Transøsofageal EKG
FPFE18	EKG-registrering med isoprenalinprovokasjon
FPFE19	EKG-registrering med isvannprovokasjon
FPFE23	Elektrofysiologisk undersøkelse av hjertet med rask stimulering mot arytmi
FPFE25	Ikke-invasiv elektrofysiogisk hjerteundersøkelse med transøsofageal stimulering
FPFE30	Langtids EKG med hendelsesregistrering
FPFE35	Invasiv elektrofysiologisk undersøkelse av hjertet
FPFE40	Invasiv elektrofysiologisk undersøkelse med 3-D bildebasert signalanalyse
FPFE45	Avlesning av langtids EKG-registrator med implanterte elektroder
FPFE50	Arbeids-EKG
FPFE55	Arbeids-EKG med spirometri og O2-opptak
FPGC00	Implantasjon av elektrode(r) for langtids EKG-registrering
FPGC05	Innlegging eller bytte av transvenøs pacemaker med atrie-, ventrikkel- og koronarveneelektrode (biventrikulær pacemaker)
FPGC10	Innlegging eller bytte av transvenøs defibrillator med atrie-, ventrikkel- og koronarveneelektrode
FPGT00	Kontroll, omprogrammering av en-kammer pacemaker eller defibrillator
FPGT05	Kontroll, omprogrammering av to-kammer pacemaker/defibrillator
FPGT10	Kontroll, omprogrammering av biventrikulær pacemaker/defibrillator
FPGT25	Testing av implantert defibrillator med provokasjon av ventrikkelflimmer
FPGX00	Rask atrie- eller ventrikkelstimulering ved implantert elektrode
FPGX05	Rask atriestimulering ved transøsofageal elektrode
FPGX10	"Invasiv elektrofysiologisk behandling av arytmi med rask atrie/ventrikkelstimulering (""overdrive pacing"")"
FPGX24	Elektrokonvertering av hjertearytmi
FYAA04	Overvåking med Swan-Ganz kateter
FYAB81	Åpen hjertekompresjon
FYDB11	Angiokardiografi ved venstre hjertekateterisering
FYDB12	Koronar angiografi ved venstre hjertekateterisering
FYDB13	Koronar angiografi med undersøkelse av koronar bypass ved venstre hjertekateterisering
FYDB14	Tilleggsundersøkelse av perifere kargebeter under angiografi ved venstre hjertekateterisering
FYDE05	Stress-ekkokardiografi
FYDE10	Ekkokardiografi med kontrast
FYDE15	Ekkokardiografi uten kontrast
FYDE20	Vevsdoppler ekkokardiografi
FYDE32	Transøsofageal ekkokardiografi
FYFF00	Hjertets minuttvolum målt ved termodilusjonsmetoder
FYFX00	Vippetest
FYFX05	Fysisk belastningstest (6 min gange eller tilsvarende)
FYFX10	Ortostatisk blodtrykksmåling
GAGT00	Kontroll/innstilling av diafragmastimulator
GAGX00	Skylling av pleuraempyem
GAGX05	Pleurolyse med fibrinolytika
GBGC00	Innlegging eller bytte av trakeostomitube
GBGC05	Fiberendoskopisk trakeal intubasjon
GBGC10	Endotrakeal intubasjon
GBGM00	Bruk av surfactant ved initial gjenoppliving umiddelbart etter fødsel
GBGM05	Bruk av surfactant senere i nyfødtperioden
GBGX10	Rensuging med sensorisk stimulans av nyfødte
GCFF05	Peak expiratory flow (PEF)-måling med anstrengelsesprovokasjon
GCFF10	Peak expiratory flow (PEF), langtidsobservasjon med automatisk logging
GCGS00	Indusert sputumprøve etter inhalasjon av hyperosmolær NaCl
GCGS05	Bronkioalveolær lavage med uthenting av vevsprøve/hvite blodlegemer
GCGX00	Bronkialtoalett
GDFC00	Spirometri
GDFC05	Spirometri med inhalasjon av hurtigvirkende bronkieutvidende legemiddel
GDFC10	Spirometri med inhalasjon av langsomtvirkende bronkieutvidende legemiddel
GDFC20	Spirometri med oscillometri for måling av perifer luftveismotstand
GDFC25	Spirometri med medikamentell provokasjon
GDFC30	Spirometri med fysisk belastning
GDFC35	Måling av funksjonell residualkapasitet med SF6- eller He-inhalasjon
GDFM00	"Måling av maksimale respiratoriske trykk og ""sniff""-test"
GDFM05	Måling av transdiafragmale trykk ved voluntær ventilasjon
GDFX00	Pletysmografi
GDFX05	Pletysmografi med måling av luftveisresistens/-konduktans I
GDFX10	Pletysmografi med måling av luftveisresistens/-konduktans II
GDFX15	Måling av gassutvekslingsevne ved karbonmonoksiddiffusjon
GDFX20	Måling av nitrogenmonoksid i ekspirasjonsluft
GDFX25	Nitrogenutvasking etter O2-inhalasjon
GDFX30	Måling av lungeelastisitet
GDFX35	Single-breath okklusjonstest for måling av luftveisresistens og compliance
GDFX40	Single-breath med nitrogentest
GEGX00	Magnetisk frenikusstimulering
GFPE05	Embolisering av arteriovenøs malformasjon i lunge
GXAV01	Respiratorbehandling INA
GXAV10	Behandling med kontinuerlig positivt luftveistrykk
GXAV20	Behandling med bifasisk positivt luftveistrykk
GXAV24	Respiratorbehandling med høyfrekvensventilasjon
GXAV25	Behandling med spesielle inhalasjonsgasser
GXDE00	Ultralydundersøkelse av pleura
GXAV35	Oppstart av behandling med hjemmerespirator
GXDE02	Transøsofageal ultralydundersøkelse
GXFX00	Høydesimuleringstest
GXFX15	Transkutan oksymetri med CO2-måling i endetidevolum
GXFX20	Transkutan noninvasiv monitorering av O2 og CO2
JAGD30	Kronisk peritonealdialyse
JAGD31	Kronisk peritonealdialyse med automatisert nattlig bytte
JAGD32	Akutt peritonealdialyse
JAGD40	Peritoneal ekvilibreringstest ved dialyse
JAGD50	Hjemmedialyse
JAGT00	Kontroll/bytte av peritonealt dialysekateter
JCFE20	Elektromyografi (EMG) i øsofagus
JCFM00	Øsofagusmanometri med provokasjonstest (ballong o.a.)
JCFM89	Øsofagusmanometri INA
JCFX10	pH-måling i øsofagus
JDDE02	Peroral endoskopisk ultralydundersøkelse
JDFX00	Urea utventilasjonstest for diagnostikk av Helicobacter pylori
JDGX00	Ventrikkelskylling
JFDE00	Ultralydundersøkelse gjennom intestinalt stoma
JFFX00	Tynntarmsundersøkelse via kapsel
JGDE12	Transrektal endoskopisk ultralydundersøkelse
JGGX05	Antegrad tarmskylling gjennom appendicostomi
JGGX10	Utprøving og stell/vedlikehold av inkontinenshjelpemiddel
JHDE00	Transanal ultralydundersøkelse
JHFE20	Elektromyografi (EMG) av analsfinkter
JHFM10	Anorektal manometri
JHGX00	Sakral nervestimulering ved inkontinens
JJGD00	Leverdialyse
JJGS05	Transjugular leverbiopsi
JJPE05	Embolisering av a. hepatica
JKDB13	Perkutan transhepatisk kolangiografi
JKFM02	Endoskopisk manometri av gallegang
JLFM02	Endoskopisk manometri av pankreasgang
JMPE05	Embolisering av a. lienalis
JXDE00	Ultralydundersøkelse av bukorganer
JXDE10	Funksjonsundersøkelse med ultralyd
JXFM00	Trykkmåling i gastrointestinaltraktus
JXFX00	Triolein pusteprøve for diagnostikk av fettmalabsorpsjon
JXFX05	Hydrogengassanalyse av ekspirasjonsluft for diagnostikk av bakteriell overvekst i tarm eller laktosemalabsorpsjon
KADE87	Ultralydundersøkelse av nyre
KADE88	Ultralydundersøkelse av nyre med Doppler, omfattende
KAFF00	Flowmåling ved dialyse
KAFM00	Urodynamisk undersøkelse av nyrebekken
KAFX00	Glomerulær filtrasjonsrate ved Iohexolmåling
KAFX10	Tubulær konsentrasjonsevne
KAGD40	Hemodialyse, kronisk
KAGD46	Hemofiltrasjon
KAGD47	Hemodialyse, akutt
KAGD48	Plasmautskifting
KAPE05	Embolisering av a. renalis
KBFM00	Urodynamisk undersøkelse av ureter
KCDE41	Ekstern ultralydundersøkelse av blære
KCDE42	Transluminal ultralydundersøkelse av blære
KCFM00	Gasscystometri
KCFM03	Vanncystometri
KCGC15	Vaginal eller anal stimulator for urininkontinens
KCGX05	Skylling av urinblære
KDDE10	Transuretral ultralydundersøkelse
KDFM03	Trykkmåling i urethra
KEDE51	Ekstern ultralydundersøkelse av prostata
KEDE52	Transluminal ultralydundersøkelse av prostata
KEFT00	Mikroskopi av sædvæske
KFDE86	Ultralydundersøkelse av scrotum
KGFE30	Elektromyografi (EMG) av corpus cavernosus
KGFF10	Blodstrømsundersøkelse i penis
KGFX25	Cavernosometri
KGFX40	Ambulatorisk ereksjonsregistrering
KGGX00	Induksjon av ereksjon
KGXJ00	Opplæring i selvinjeksjon i penis
KXFC00	Døgnmåling av urinvolum, ev. ved veiing av bleier
KXFE00	Elektromyografi (EMG) i bekkenbunnen
KXFE80	Urologisk elektromyografi (EMG)
KXFF00	Uroflowmetri
KXFM20	Ambulatorisk urodynamisk undersøkelse
KXFT00	Uretralutstryk med mikroskopi
KXFX00	Test på stressinkontinens
KXFX05	Kontinenstest med måling >12 timer av urin- og drikkevolum
KXFX06	Fysiologisk miksjonsundersøkelse
KXFX08	Miksjonsobservasjon > 4 timer
KXGX00	Infertilitetsutredning hos mann
LCGX10	Intracytoplasmatisk spermieinjeksjon (ICSI)
LCGX15	Nedfrysing av embryo
LCGX20	Intrauterin inseminasjon
LCPE05	Embolisering av a. uterina
LEET00	Kolposkopi
LEFT20	Vaginalutstryk med mikroskopi
LXDE00	Undersøkelse av livmorhule/eggledere med væskesonografi
LXDE05	Ultralydundersøkelse med vaginal probe
LXGX99	Infertilitetsutredning hos kvinne IKA
MADE00	Vaginal ultralydundersøkelse av livmorhals
MADE10	Abdominal ultralydundersøkelse av gravid livmor
MAFE05	Overvåking med foster-EKG
MAFX10	pH-måling i fosterskalp
MAGM00	Medikamentell svangerskapsavbrytelse
MAGM05	Fødselsinduksjon med prostaglandin peroralt
MAGM10	Fødselsinduksjon med legemiddel intravenøst
MAGM11	Ristimulering med legemiddel intravenøst
MAGM16	Fødselsinduksjon med legemiddel i cervix
MAGX09	Amnionreduksjon
MBGS00	Prøvetaking av navleveneblod
NBGX46	Kjemisk synoviortese av skulderledd
NBGX47	Synoviortese av skulderledd med radioaktive isotoper
NBSY21	Tilpasning av ekstern protese på skulder
NBSY22	Tilpasning av ekstern protese på overarm
NBSY27	Tilpasning av myoelektrisk protese på overekstremitet
NBSY35	Tilpasning av patellarsenebærende protese
NCGX36	Kjemisk synoviortese av albueledd
NCGX37	Synoviortese av albueledd med radioaktive isotoper
NCSY23	Tilpasning av ekstern protese på albue
NCSY24	Tilpasning av ekstern protese på underarm
NDFT00	Mikroskopi av neglesenger med vurdering av kapillærseng
NDFX05	Elektrogoniometri - håndleddsvinkelmåling
NDGX06	Kjemisk synoviortese av fingerledd
NDGX07	Synoviortese med radioaktive isotoper, fingerledd
NDGX16	Kjemisk synoviortese av karpo-metakarpalledd
NDGX17	Synoviortese med radioaktive isotoper, karpo-metakarpalledd
NDSY25	Tilpasning av ekstern protese på håndledd
NDSY26	Tilpasning av ekstern protese på finger
NFGX56	Kjemisk synoviortese av hofteledd
NFGX57	Synoviortese av hofteledd med radioaktive isotoper
NFSY31	Tilpasning av ekstern protese etter hemipelvektomi eller eksartikulasjon i hofte
NFSY32	Tilpasning av ekstern protese på lår
NFSY36	Tilpasning av suprakondylær protese på lår
NGGX66	Kjemisk synoviortese av knedledd
NGGX67	Synoviortese av kneledd med radioaktive isotoper
NGSY33	Tilpasning av ekstern protese etter eksartikulasjon i kneledd
NGSY34	Tilpasning av ekstern protese på legg med lårkorsett
NGSY39	Tilpasning av annen ekstern protese på underekstremitet
NHGX76	Kjemisk synoviortese av ankelledd
NHGX77	Synoviortese av ankelledd med radioaktive isotoper
NHGX86	Kjemisk synoviortese av tarsalledd
NHGX87	Synoviortese av tarsalledd med radioaktive isotoper
NHGX96	Kjemisk synoviortese av tåledd
NHGX97	Synoviortese av tåledd med radioaktive isotoper
NHSY38	Tilpasning av ekstern protese på fot eller forfot
NMFM00	Måling av intramuskulært trykk uten provokasjon
NMFM05	Måling av intramuskulært trykk med provokasjon
NXDE00	Ultralydveiledet leddpunksjon
NXDE15	Ultralydundersøkelse av ledd og/eller bløtdeler
NXFM94	Innlegging av elektrode i bevegelsesapparatet for trykkregistrering eller stimulering av beinvekst
NXFT00	Mikroskopisk undersøkelse av leddvæske
NXFT05	Mikroskopisk undersøkelse av leddvæske med polarisert lys
NXFX05	Bentetthetsmåling
NXGX20	Databasert bevegelsesanalyse
NXGX23	Leddskylling
NXGX86	Kjemisk synoviortese av andre ledd
NXGX87	Synoviortese av andre ledd med radioaktive isotoper
NXGX96	Resynovektomi med kjemisk synoviortese
NXGX97	Resynovektomi med synoviortese med radioaktive isotoper
NXSY01	Tilpasning av redresserende plastkorsett
NXSY03	Tilpasning av reklinerende plastkorsett
NXSY05	Tilpasning av kroppskorsett utenom etter operasjon
NXSY06	Tilpasning av kroppskorsett postoperativt
NXSY07	Tilpasning av tøykorsett forsterket med spiler eller plater
NXSY08	Tilpasning av sittekurv
NXSY37	Tilpasning av Symes eller Boyd protese
PHFC00	Venøs okklusjonspletysmografi
PHFC05	Fotvolumetri
PHFM00	Invasiv måling av trykk i perifer vene
PHGX00	Innlegging eller bytte av tunnelert dialysekateter
PHGX05	Innlegging eller bytte av ikke-tunnelert dialysekateter
PHGX10	Venetømmingsbestemmelse
PJGX05	Manuell lymfedrenasje
PJGX10	Punksjon av lymfocele
PKFF00	Laser-Doppler flowmetri i kapillærer
PKFF05	Laser-Doppler flowmetri med provokasjon i kapillærer
PKFM00	Måling av kolloidosmotisk trykk
PKFT00	Mikrovaskulær undersøkelse med kapillærmikroskopi
PKFX00	Måling av kapillær filtrasjonskoeffisient
PUGC00	Innlegging eller bytte av navlevenekateter
PUGC05	Innlegging eller bytte av navlearteriekateter
PYDB91	Peroperativ angiografi ved perifer karkirurgi
PYDB92	Peroperativ angioskopi ved perifer karkirurgi
PYDE00	Ultralyd dupleks undersøkelse av halskar, enkel
PYDE05	Ultralyd dupleks undersøkelse av halskar, fullstendig
PYDE09	Ultralyd undersøkelse av perifere arterier IKA
PYDE95	Peroperativ Doppler ultralydundersøkelse ved perifer karkirurgi 
PYDE96	Peroperativ dupleks ultralydundersøkelse ved perifer karkirurgi
PYFF93	Peroperativ flowmåling ved perifer karkirurgi
PYFM10	Måling av ankel-arm blodtrykksindeks under kontrollert, tyngre arbeidsbelastning
PYFM20	Måling av blodtrykk i tå/finger
PYFM25	Langtids noninvasiv blodtrykksmåling
PYFM30	Invasiv arteriell blodtrykksmåling
PYFM94	Peroperativ trykkmåling ved perifer karkirurgi
PYFX00	Måling av pulsbølgehastighet og lignende
PYFX10	Registrering av arterielle pulsvolumkurver med pletysmografi I
PYFX15	Registrering av arterielle pulsvolumkurver med pletysmografi II
QXFT00	Soppdiagnostikk ved mikroskopi
QXFT05	Skabbdiagnostikk ved mikroskopi
QXFT10	Mørkefeltmikroskopi
QXFX00	Undersøkelse med Woods lys
QXFX05	Lystest
QXFX10	Fotopatchtest ved mistenkt fotoallergi
QXFX15	Svettetest I
QXFX20	Svettetest II
QXGM00	Iontoferese ved hyperhidrose
QXGX00	Grensestrålebehandling
QXGX10	Lysbehandling
QXGX20	Lysbehandling av nyfødte
QXGX25	Systemisk psoralen-ultrafiolett-behandling
QXGX30	Lokal psoralen-ultrafiolett-behandling
QXGX35	Fotodynamisk terapi
QXGX50	Dermojetbehandling
RAGD00	Cytaferese av stamceller
RAGG15	Transfusjon av allogene stamceller fra perifert blod, beslektet giver
RAGG20	Transfusjon av allogene stamceller fra perifert blod, ubeslektet giver
RAGG25	Transfusjon av autologe stamceller fra beinmarg
RAGG30	Transfusjon av autologe stamceller fra perifert blod
RAGG35	Transfusjon av stamceller fra navlestrengsblod, beslektet giver
RAGG40	Transfusjon av stamceller fra navlestrengsblod, ubeslektet giver
RAGG50	Beinmargstransplantasjon, ubeslektet giver
RAGG55	Beinmargstransplantasjon, beslektet giver
RAGX00	Mobilisering for allogen stamcellehøsting
RAGX05	Mobilisering for autolog stamcellehøsting
REGD00	Erytrocyttaferese
REGD05	Erytrocyttreduserende cytaferese
REGG00	Transfusjon av allogene erytrocytter
REGG05	Transfusjon av autologe erytrocytter
REGG10	Intrauterin transfusjon av erytrocytter
RKGM00	Infusjon av koagulasjonsfaktorkonsentrat
RKGM05	Infusjon av rekombinante koagulasjonsfaktorpreparater
RLGD00	Leukaferese
RLGD05	Leukocyttreduserende cytaferese
RLGG00	Transfusjon av granulocytter
RLGG05	Transfusjon av lymfocytter
RLGG10	Infusjon av donators lymfocytter (DLI) til beinmargstransplantert pasient
RPGD00	Plasmaferese med dobbelfiltrasjon
RPGD05	Plasmaferese med immunadsorpsjon
RPGD10	Plasmaferese med LDL-adsorpsjon
RPGD15	Plasmaferese med stamcellehøsting
RPGG00	Transfusjon av plasma, autolog
RPGG05	Transfusjon av plasma, allogen
RPGM00	Infusjon av albumin
RPGM05	Infusjon av gammaglobulin
RPGX00	Plasmatapping
RTGD00	Trombocyttaferese
RTGD05	Trombocyttreduserende cytaferese
RTGG00	Allogen transfusjon av trombocytter
RTGG05	Autolog transfusjon av trombocytter
RTGG10	Intrauterin transfusjon av trombocytter
RXFC00	Plasmavolumbasert beregning av blodvolum
RXFC05	Erytrocyttvolumbasert beregning av blodvolum
RXGD00	Cytaferese, ekstrakorporal fotokjemoterapi
RXGD05	Hemodiafiltrasjon
RXGD10	Hemodilusjon preoperativt
RXGD15	Hemoperfusjon
RXGG02	Transfusjon med fullblod, allogen
RXGG03	Transfusjon med fullblod, autolog
RXGG05	Intrauterin blodtransfusjon til foster
RXGG10	Transfusjon av sårblod fra dren
RXGG15	Transfusjon av erytrocytter fra peroperativt gjenvunnet sårblod (cellsaver)
RXGG61	Utskiftningstransfusjon hos nyfødt
RXGX00	Fullblodstapping av blodgiver
RXGX05	Terapeutisk fullblodstapping
RXGX65	Bestråling av blodprodukter
WAGX09	Vaksinasjoner INA
WBGC00	Innlegging eller bytte av legemiddelpumpe
WBGC05	Fjerning av implantert legemiddelpumpe
WBGC10	Påfylling av implantert legemiddelpumpe
WBGM00	Intravenøs injeksjon/infusjon av legemiddel
WBGM05	Intramuskulær injeksjon av legemiddel
WBGM10	Subkutan injeksjon av legemiddel
WBGM15	Peroral administrasjon av legemiddel
WBGM20	Inhalasjon av legemiddel
WBGM25	Nasal administrasjon av legemiddel
WBGM30	Intratekal injeksjon av legemiddel
WBGM35	Intravesikal administrasjon av legemiddel
WBGM40	Intraperitoneal administrasjon av legemiddel
WBGM45	Administrasjon av legemiddel ved lokal applikasjon
WBGM50	Iontoforetisk tilførsel av legemiddel
WBGM55	Intravaginal administrasjon av legemiddel
WBGM60	Subkutan implantasjon av legemiddel i fast form
WBGM65	Intrarektal administrasjon av legemiddel
WBGM70	Injeksjon i muskelfester/senefester/bursa
WBOC05	Intravenøs injeksjon/infusjon av cytostatika
WBOC08	Intravenøs injeksjon/infusjon av adjuvans til cytostatikabehandling
WBOC10	Intramuskulær injeksjon/infusjon av cytostatika
WBOC15	Subkutan injeksjon/infusjon av cytostatika
WBOC20	Peroral cytostatikabehandling
WBOC25	Intratekal injeksjon/infusjon av cytostatika
WBOC30	Intravesikal administrasjon av cytostatika
WBOC39	Cytostatikabehandling INA
WDAA10	Anestesidybde monitorering
WDAB00	Hjertemassasje umiddelbart etter fødsel
WDAB05	Hjertemassasje senere under nyfødtperiode
WDAB09	Opplivingstiltak på nyfødte IKA
WDAB45	Behandling med antisjokkbukse - MAST eller tilsvarende
WDAB50	Intensivovervåking under transport
WDAB55	Ekstrakorporal membranoksygenering
WDAB80	Lukket hjertekompresjon
WDAG09	Generell anestesi INA
WDAG20	Generell anestesi med inhalasjonsmidler
WDAG25	Generell anestesi med intravenøse midler
WDAG30	Generell anestesi med inhalasjonsmidler og intravenøse midler
WDAJ05	Sedering under overvåking
WDAJ10	Våken sedering med injeksjonsmidler
WDAJ15	Dyp sedering v/anestesiologisk spesialpersonell
WDAL05	Infiltrasjon for lokalanestesi
WDAL06	Ledningsanestesi IKA
WDAL08	Intravenøs regionalanestesi
WDAL09	Overflateanestesi IKA
WDAL15	Akupunktur
WDAL30	Spinalanestesi
WDAL34	Epiduralanestesi
WDAP05	Triggerpunktsblokade
WDAP09	Regional blokade IKA
WDAP10	Subakromial blokade
WDAP12	Supraklavikulærblokade
WDAP15	Interskalenær pleksusblokade
WDAP17	Aksillær pleksusblokade
WDAP20	Spinalblokade
WDAP22	Epiduralblokade
WDAP23	Kombinert spinal/epidural blokade
WDAP25	Interpleuralblokade
WDAP27	Interkostalblokade
WDAP29	Annen sentral blokade
WDAP30	Splanknikusblokade
WDAP32	Hypogastricusblokade
WDAP35	Stellatumblokade
WDAP37	Coeliacusblokade
WDAP40	Regional i.v. sympatikusblokade
WDAP42	Sympatikusblokade, paravertebral
WDAP43	Sympatikusblokade, lumbal
WDAP44	Sympatikusblokade, torakal
WDAP46	Sympatikusblokade med iontoforese
WDAP49	Sympatikusblokade INA
WDAP55	Diskusblokade
WDAP57	Fasettleddsblokade
WDAP60	Fasettleddsblokade med gjennomlysning
WDAP62	Sakralblokade
WDAP65	Sakroiliakablokade
WDAP67	Inguinalblokade
WDAP70	Pudendusblokade
WDAP72	Penisblokade
WDAP75	Ischiadicusblokade
WDAP77	Femoralisblokade
WDAP79	Muskelblokade INA
WDAP80	Ankelblokade
WDAP89	Perifer nerveblokade INA
WDFX05	Diagnostisk rotblokade
WDFX10	Adenosintest mhp smertepåvirkning
WDFX15	Opioidtest mhp nociceptiv smerte
WDFX20	Xylocaintest mhp nevrogen smerte
WDFX25	Regitintest på sympatikusmediert smerte
WDFX30	Ketamintest mhp respons på N-methyl-D-aspartat-blokker
WDGX25	Terapeutisk hypotermi
WDGX30	Overflateoppvarming ved hypotermi
WDGX35	Ekstrakorporal oppvarming
WDGX40	Peritoneal oppvarming
WDGX50	Kuvøsebehandling
WEGT00	Kontroll av strålefelt, statisk
WEGT05	Kontroll av strålefelt, dynamisk
WEGT10	Kontroll av pasientens anatomi før behandling, statisk
WEGT15	Kontroll av kilde/applikatorposisjon ved brakyterapi
WEGT20	Dosimetrisk kontroll av pasientdoser
WEGX05	Doseplan, 2D, ekstern terapi og brakyterapi
WEGX10	Doseplan, 3D, volumbasert
WEGX15	Simulering av feltinnstilling før strålebehandling
WEGX18	Doseplan for intensitetsmodulert stråleterapi (IMRT)
WEGX20	Doseplan for spesialopplegg IKA
WEOA00	Ekstern stråleterapi, høyenergetisk (MV)
WEOA05	Ekstern stråleterapi, lavenergetisk (kV)
WEOA10	Ekstern stråleterapi, helkropp
WEOA15	Ekstern stråleterapi med spesialapparat
WEOB00	Brakyterapi, applikatorinnsetting
WEOB05	Brakyterapi med høy doserate (HDR)
WEOB10	Brakyterapi med pulset doserate (PDR)
WEOB15	Brakyterapi med lav doserate (LDR)
WEOB20	Brakyterapi, intravaskulær (IVBT)
WGFX00	Prikktest luftpanel
WGFX05	Prikktest matpanel
WGFX10	Prikktest - eget testmateriale fra hjemmemiljø eller arbeidsplass
WGFX15	Epikutantest med standardiserte prøver
WGFX20	Epikutantest - eget materiale fra hjemmemiljø eller arbeidsplass
WGFX25	Allergenprovokasjon - peroral åpen (kjent innhold)
WGFX30	Allergenprovokasjon - peroral dobbelblind (ukjent innhold for pasient og lege)
WGFX35	Allergenprovokasjon, nasal
WGFX40	Næringsmiddeloverfølsomhet - utredning
WGFX45	Legemiddeloverfølsomhet - utredning
WGGM00	Hyposensibilisering
WGGM05	Hurtighyposensibilisering
WJAT00	Parenteral ernæring med eller uten tilsetningsstoffer
WJAT10	Total enteral ernæring med eller uten tilsetningsstoffer, i sonde
WJAT15	Ernæringsbehandling med spesialkost/individuelt tilpasset kost
WJAT20	Morsmelkernæring av premature
WJFX10	Indirekte kalorimetri
WJFX99	Vurdering av ernæringsstatus IKA
WKRT10	PC-arbeidsplassutredning
WKRT20	Yrkeshygienisk utredning IKA
WKRT25	Yrkesmedisinsk utredning IKA
WKRT30	Ergonomisk utredning IKA
WKRT35	Arbeidsplassutredning IKA
WKRT99	Miljømedisinsk utredning IKA
WLFX05	Tuberkulintest
WLGP00	Oppstart av kronisk oksygenbehandling i hjemmet
WLGP20	Hyperbar oksygenbehandling - tabell 5
WLGP22	Hyperbar oksygenbehandling - tabell 6
WLGP24	Hyperbar oksygenbehandling - tabell 14/90
WLGP26	Hyperbar oksygenbehandling - tabell 20/60
WLGP28	Hyperbar oksygenbehandling - tabell 20/90
WLGP29	Hyperbar oksygenbehandling INA
WLGX10	Ødembehandling med kompresjonspumpe/pumpestøvel
WLGX15	Behandling med von Rosenskinne
WLGX20	Vakuumassistert sårbehandling
WLGX25	Sårbehandling med fluelarver
WLGX30	Badebehandling - helkropp
WLGX35	Badebehandling - lokal
WLGX40	Bio-feedback for påvirkning av egne kroppsfunksjoner
WLGX50	Isolasjon
WLGX55	Etablering av individuell plan
WURB05	Kognitiv funksjonstrening
WURB15	Kommunikativ funksjonstrening
WURX00	Nevropsykologisk testing
WURX05	Testing av utviklingsnivå
WURX20	Undersøkelse av kommunikasjonsevne, oralmotoriske funksjoner og tale
ZWN 00	To - fire like behandlinger/undersøkelser i samme seanse
ZWN 05	Fem eller flere like behandlinger/undersøkelser i samme seanse
ZWU 15	Undersøkelse på ufødt barn
ZWU 30	Bruk av videoopptak og gransking av opptak
ZWU 40	Bruk av telemedisin



